date,ALL,A,NS,CNAME,PTR,TXT,AAAA
2014-01-07 17,33,11,22,0,0,0,0
2014-01-07 18,36,12,24,0,0,0,0
2014-01-07 19,105,35,70,0,0,0,0
2014-01-07 20,18,6,12,0,0,0,0
2014-01-07 21,72,24,48,0,0,0,0
2014-01-07 22,111,37,74,0,0,0,0
2014-01-07 23,21,7,14,0,0,0,0
2014-01-08 00,66,22,44,0,0,0,0
2014-01-08 07,15,5,10,0,0,0,0
2014-01-08 08,12,4,8,0,0,0,0
2014-01-08 09,15,5,10,0,0,0,0
2014-01-08 10,12,4,8,0,0,0,0
2014-01-08 11,18,6,12,0,0,0,0
2014-01-08 12,3,1,2,0,0,0,0
2014-01-08 13,12,4,8,0,0,0,0
2014-01-08 14,18,6,12,0,0,0,0
2014-01-08 15,18,6,12,0,0,0,0
2014-01-08 16,93,31,62,0,0,0,0
2014-01-08 17,21,7,14,0,0,0,0
2014-01-08 18,45,15,30,0,0,0,0
2014-01-08 19,12,4,8,0,0,0,0
2014-01-08 20,24,8,16,0,0,0,0
2014-01-08 21,90,30,60,0,0,0,0
2014-01-08 22,30,10,20,0,0,0,0
2014-01-08 23,30,10,20,0,0,0,0
2014-01-09 00,12,4,8,0,0,0,0
2014-01-09 01,6,2,4,0,0,0,0
2014-01-09 08,9,3,6,0,0,0,0
2014-01-09 09,102,34,68,0,0,0,0
2014-01-09 10,39,13,26,0,0,0,0
2014-01-09 11,60,20,40,0,0,0,0
2014-01-09 12,18,6,12,0,0,0,0
2014-01-09 13,33,11,22,0,0,0,0
2014-01-09 14,24,8,16,0,0,0,0
2014-01-09 15,21,7,14,0,0,0,0
2014-01-09 16,24,8,16,0,0,0,0
2014-01-09 17,123,41,82,0,0,0,0
2014-01-09 18,132,44,88,0,0,0,0
2014-01-09 19,108,36,72,0,0,0,0
2014-01-09 20,69,23,46,0,0,0,0
2014-01-09 21,87,29,58,0,0,0,0
2014-01-09 22,15,5,10,0,0,0,0
2014-01-09 23,84,28,56,0,0,0,0
2014-01-10 00,3,1,2,0,0,0,0
2014-01-10 01,3,1,2,0,0,0,0
2014-01-10 05,3,1,2,0,0,0,0
2014-01-10 07,3,1,2,0,0,0,0
2014-01-10 08,14,6,8,0,0,0,0
2014-01-10 09,12,4,8,0,0,0,0
2014-01-10 10,18,6,12,0,0,0,0
2014-01-10 11,9,3,6,0,0,0,0
2014-01-10 12,210,70,140,0,0,0,0
2014-01-10 13,45,15,30,0,0,0,0
2014-01-10 14,27,9,18,0,0,0,0
2014-01-10 15,78,26,52,0,0,0,0
2014-01-10 16,114,38,76,0,0,0,0
2014-01-10 17,108,36,72,0,0,0,0
2014-01-10 18,15,5,10,0,0,0,0
2014-01-10 19,48,16,32,0,0,0,0
2014-01-10 20,21,7,14,0,0,0,0
2014-01-10 21,18,6,12,0,0,0,0
2014-01-10 22,9,3,6,0,0,0,0
2014-01-10 23,12,4,8,0,0,0,0
2014-01-11 00,18,6,12,0,0,0,0
2014-01-11 06,3,1,2,0,0,0,0
2014-01-11 09,15,5,10,0,0,0,0
2014-01-11 10,15,5,10,0,0,0,0
2014-01-11 11,69,23,46,0,0,0,0
2014-01-11 12,18,6,12,0,0,0,0
2014-01-11 13,21,7,14,0,0,0,0
2014-01-11 14,9,3,6,0,0,0,0
2014-01-11 20,15,5,10,0,0,0,0
2014-01-11 21,90,30,60,0,0,0,0
2014-01-11 23,27,9,18,0,0,0,0
2014-01-13 16,63,21,42,0,0,0,0
2014-01-13 17,18,6,12,0,0,0,0
2014-01-13 18,45,15,30,0,0,0,0
2014-01-13 19,87,29,58,0,0,0,0
2014-01-13 20,120,40,80,0,0,0,0
2014-01-13 21,69,23,46,0,0,0,0
2014-01-13 22,66,22,44,0,0,0,0
2014-01-13 23,81,27,54,0,0,0,0
2014-01-14 00,12,4,8,0,0,0,0
2014-01-14 01,3,1,2,0,0,0,0
2014-01-14 02,3,1,2,0,0,0,0
2014-01-14 08,3,1,2,0,0,0,0
2014-01-14 09,21,7,14,0,0,0,0
2014-01-14 10,18,6,12,0,0,0,0
2014-01-14 11,129,43,86,0,0,0,0
2014-01-14 12,45,15,30,0,0,0,0
2014-01-14 13,21,7,14,0,0,0,0
2014-01-14 14,3625,1207,2418,0,0,0,0
2014-01-14 15,54,18,36,0,0,0,0
2014-01-14 16,117,39,78,0,0,0,0
2014-01-14 17,27,9,18,0,0,0,0
2014-01-14 18,78,26,52,0,0,0,0
2014-01-14 19,93,31,62,0,0,0,0
2014-01-14 20,30,10,20,0,0,0,0
2014-01-14 21,36,12,24,0,0,0,0
2014-01-14 22,54,18,36,0,0,0,0
2014-01-14 23,18,6,12,0,0,0,0
2014-01-15 00,24,8,16,0,0,0,0
2014-01-15 01,6,2,4,0,0,0,0
2014-01-15 02,6,2,4,0,0,0,0
2014-01-15 03,33,11,22,0,0,0,0
2014-01-15 08,6,2,4,0,0,0,0
2014-01-15 09,30,10,20,0,0,0,0
2014-01-15 10,27,9,18,0,0,0,0
2014-01-15 11,24,8,16,0,0,0,0
2014-01-15 12,18,6,12,0,0,0,0
2014-01-15 13,54,18,36,0,0,0,0
2014-01-15 14,21,7,14,0,0,0,0
2014-01-15 15,24,8,16,0,0,0,0
2014-01-15 16,18,6,12,0,0,0,0
2014-01-15 17,27,9,18,0,0,0,0
2014-01-15 18,6,2,4,0,0,0,0
2014-01-15 20,198,66,132,0,0,0,0
2014-01-15 21,84,28,56,0,0,0,0
2014-01-15 22,102,34,68,0,0,0,0
2014-01-15 23,42,14,28,0,0,0,0
2014-01-16 00,39,13,26,0,0,0,0
2014-01-16 01,24,8,16,0,0,0,0
2014-01-16 02,33,11,22,0,0,0,0
2014-01-16 03,36,12,24,0,0,0,0
2014-01-16 04,30,10,20,0,0,0,0
2014-01-16 05,33,11,22,0,0,0,0
2014-01-16 06,36,12,24,0,0,0,0
2014-01-16 07,36,12,24,0,0,0,0
2014-01-16 08,36,12,24,0,0,0,0
2014-01-16 09,36,12,24,0,0,0,0
2014-01-16 10,27,9,18,0,0,0,0
2014-01-16 11,84,28,56,0,0,0,0
2014-01-16 12,114,38,76,0,0,0,0
2014-01-16 13,15,5,10,0,0,0,0
2014-01-16 14,111,37,74,0,0,0,0
2014-01-16 15,84,28,56,0,0,0,0
2014-01-16 16,12,4,8,0,0,0,0
2014-01-16 17,15,5,10,0,0,0,0
2014-01-16 18,3,1,2,0,0,0,0
2014-01-16 19,18,6,12,0,0,0,0
2014-01-16 20,27,9,18,0,0,0,0
2014-01-16 21,12,4,8,0,0,0,0
2014-01-16 22,6,2,4,0,0,0,0
2014-01-16 23,27,9,18,0,0,0,0
2014-01-17 00,18,6,12,0,0,0,0
2014-01-17 01,3,1,2,0,0,0,0
2014-01-17 07,779,257,522,0,0,0,0
2014-01-17 09,18,6,12,0,0,0,0
2014-01-17 10,6,2,4,0,0,0,0
2014-01-17 11,18,6,12,0,0,0,0
2014-01-17 12,7,3,4,0,0,0,0
2014-01-17 13,117,39,78,0,0,0,0
2014-01-17 14,108,36,72,0,0,0,0
2014-01-17 15,6,2,4,0,0,0,0
2014-01-17 17,3,1,2,0,0,0,0
2014-01-17 18,6,2,4,0,0,0,0
2014-01-17 19,6,2,4,0,0,0,0
2014-01-17 20,21,7,14,0,0,0,0
2014-01-17 21,6,2,4,0,0,0,0
2014-01-18 00,3,1,2,0,0,0,0
2014-01-18 02,3,1,2,0,0,0,0
2014-01-18 08,3,1,2,0,0,0,0
2014-01-18 09,9,3,6,0,0,0,0
2014-01-18 10,15,5,10,0,0,0,0
2014-01-18 11,165,55,110,0,0,0,0
2014-01-18 12,6,2,4,0,0,0,0
2014-01-18 13,12,4,8,0,0,0,0
2014-01-18 14,14,6,8,0,0,0,0
2014-01-18 15,9,3,6,0,0,0,0
2014-01-18 16,12,4,8,0,0,0,0
2014-01-18 17,6,2,4,0,0,0,0
2014-01-18 18,18,6,12,0,0,0,0
2014-01-18 19,9,3,6,0,0,0,0
2014-01-18 20,99,33,66,0,0,0,0
2014-01-18 21,33,11,22,0,0,0,0
2014-01-18 22,15,5,10,0,0,0,0
2014-01-18 23,18,6,12,0,0,0,0
2014-01-19 00,3,1,2,0,0,0,0
2014-01-19 01,15,5,10,0,0,0,0
2014-01-19 03,9,3,6,0,0,0,0
2014-01-19 06,3,1,2,0,0,0,0
2014-01-19 09,6,2,4,0,0,0,0
2014-01-19 11,9,3,6,0,0,0,0
2014-01-19 12,21,7,14,0,0,0,0
2014-01-19 13,9,3,6,0,0,0,0
2014-01-19 14,6,2,4,0,0,0,0
2014-01-19 15,12,4,8,0,0,0,0
2014-01-19 16,42,14,28,0,0,0,0
2014-01-19 17,27,9,18,0,0,0,0
2014-01-19 18,12,4,8,0,0,0,0
2014-01-19 19,57,19,38,0,0,0,0
2014-01-19 20,72,24,48,0,0,0,0
2014-01-19 21,42,14,28,0,0,0,0
2014-01-19 22,3,1,2,0,0,0,0
2014-01-19 23,111,37,74,0,0,0,0
2014-01-20 00,9,3,6,0,0,0,0
2014-01-20 02,3,1,2,0,0,0,0
2014-01-20 08,12,4,8,0,0,0,0
2014-01-20 10,9,3,6,0,0,0,0
2014-01-20 11,9,3,6,0,0,0,0
2014-01-20 12,6,2,4,0,0,0,0
2014-01-20 14,9,3,6,0,0,0,0
2014-01-20 15,6,2,4,0,0,0,0
2014-01-20 16,6,2,4,0,0,0,0
2014-01-20 17,9,3,6,0,0,0,0
2014-01-20 18,3,1,2,0,0,0,0
2014-01-20 19,24,8,16,0,0,0,0
2014-01-20 20,6,2,4,0,0,0,0
2014-01-20 21,3,1,2,0,0,0,0
2014-01-20 22,9,3,6,0,0,0,0
2014-01-20 23,3,1,2,0,0,0,0
2014-01-21 00,3,1,2,0,0,0,0
2014-01-21 01,3,1,2,0,0,0,0
2014-01-21 02,3,1,2,0,0,0,0
2014-01-21 03,3,1,2,0,0,0,0
2014-01-21 09,18,6,12,0,0,0,0
2014-01-21 10,12,4,8,0,0,0,0
2014-01-21 11,9,3,6,0,0,0,0
2014-01-21 12,6,2,4,0,0,0,0
2014-01-21 13,15,5,10,0,0,0,0
2014-01-21 15,12,6,4,0,0,2,0
2014-01-21 16,3,1,2,0,0,0,0
2014-01-21 17,6,2,4,0,0,0,0
2014-01-21 18,25,9,16,0,0,0,0
2014-01-21 19,6,2,4,0,0,0,0
2014-01-21 20,33,11,22,0,0,0,0
2014-01-21 21,111,37,74,0,0,0,0
2014-01-21 22,72,24,48,0,0,0,0
2014-01-21 23,39,13,26,0,0,0,0
2014-01-22 00,3,1,2,0,0,0,0
2014-01-22 01,3,1,2,0,0,0,0
2014-01-22 07,157,52,104,1,0,0,0
2014-01-22 08,12,4,8,0,0,0,0
2014-01-22 09,88,29,58,1,0,0,0
2014-01-22 10,21,7,14,0,0,0,0
2014-01-22 11,58,20,38,0,0,0,0
2014-01-22 13,3,3,0,0,0,0,0
2014-01-22 15,3,1,2,0,0,0,0
2014-01-22 16,6,2,4,0,0,0,0
2014-01-22 19,6,2,4,0,0,0,0
2014-01-22 20,9,3,6,0,0,0,0
2014-01-22 21,12,4,8,0,0,0,0
2014-01-22 22,12,4,8,0,0,0,0
2014-01-22 23,48,16,32,0,0,0,0
2014-01-23 00,9,3,6,0,0,0,0
2014-01-23 01,6,2,4,0,0,0,0
2014-01-23 13,3,1,2,0,0,0,0
2014-01-23 14,3,1,2,0,0,0,0
2014-01-23 15,15,5,10,0,0,0,0
2014-01-23 16,3,1,2,0,0,0,0
2014-01-23 17,12,4,8,0,0,0,0
2014-01-23 18,3,1,2,0,0,0,0
2014-01-23 19,3,1,2,0,0,0,0
2014-01-23 21,3,1,2,0,0,0,0
2014-01-23 22,6,2,4,0,0,0,0
2014-01-23 23,6,2,4,0,0,0,0
2014-01-24 00,3,1,2,0,0,0,0
2014-01-24 08,3,1,2,0,0,0,0
2014-01-24 09,3,1,2,0,0,0,0
2014-01-24 14,3,1,2,0,0,0,0
2014-01-24 15,6,2,4,0,0,0,0
2014-01-24 16,6,2,4,0,0,0,0
2014-01-24 17,9,3,6,0,0,0,0
2014-01-24 20,6,2,4,0,0,0,0
2014-01-24 21,6,2,4,0,0,0,0
2014-01-24 22,12,4,8,0,0,0,0
2014-01-24 23,3,1,2,0,0,0,0
2014-01-25 00,6,2,4,0,0,0,0
2014-01-25 01,3,1,2,0,0,0,0
2014-01-25 03,3,1,2,0,0,0,0
2014-01-25 04,3,1,2,0,0,0,0
2014-01-25 05,3,1,2,0,0,0,0
2014-01-25 08,3,1,2,0,0,0,0
2014-01-25 10,3,1,2,0,0,0,0
2014-01-25 11,3,1,2,0,0,0,0
2014-01-25 12,6,2,4,0,0,0,0
2014-01-25 13,3,1,2,0,0,0,0
2014-01-25 15,3,1,2,0,0,0,0
2014-01-25 16,117,39,78,0,0,0,0
2014-01-25 17,3,1,2,0,0,0,0
2014-01-25 19,3,1,2,0,0,0,0
2014-01-25 20,3,1,2,0,0,0,0
2014-01-25 21,6,2,4,0,0,0,0
2014-01-25 22,3,1,2,0,0,0,0
2014-01-25 23,6,2,4,0,0,0,0
2014-01-26 00,6,2,4,0,0,0,0
2014-01-26 02,3,1,2,0,0,0,0
2014-01-26 05,6,2,4,0,0,0,0
2014-01-26 11,3,1,2,0,0,0,0
2014-01-26 12,3,1,2,0,0,0,0
2014-01-26 13,3,1,2,0,0,0,0
2014-01-26 16,3,1,2,0,0,0,0
2014-01-26 17,3,1,2,0,0,0,0
2014-01-26 21,15,5,10,0,0,0,0
2014-01-26 22,43,15,28,0,0,0,0
2014-01-26 23,3,1,2,0,0,0,0
2014-01-27 06,3,1,2,0,0,0,0
2014-01-27 09,3,1,2,0,0,0,0
2014-01-27 11,6,2,4,0,0,0,0
2014-01-27 12,3,1,2,0,0,0,0
2014-01-27 14,81,27,54,0,0,0,0
2014-01-27 15,3,1,2,0,0,0,0
2014-01-27 20,3,1,2,0,0,0,0
2014-01-27 22,3,1,2,0,0,0,0
2014-01-27 23,3,1,2,0,0,0,0
2014-01-28 00,3,1,2,0,0,0,0
2014-01-28 01,15,5,10,0,0,0,0
2014-01-28 09,3,1,2,0,0,0,0
2014-01-28 11,3,1,2,0,0,0,0
2014-01-28 12,3,1,2,0,0,0,0
2014-01-28 20,6,2,4,0,0,0,0
2014-01-28 22,3,1,2,0,0,0,0
2014-01-29 00,3,1,2,0,0,0,0
2014-01-29 10,6,2,4,0,0,0,0
2014-01-29 11,3,1,2,0,0,0,0
2014-01-29 12,9,3,6,0,0,0,0
2014-01-29 13,3,1,2,0,0,0,0
2014-01-29 15,3,1,2,0,0,0,0
2014-01-29 21,6,2,4,0,0,0,0
2014-01-29 22,12,4,8,0,0,0,0
2014-01-30 02,3,1,2,0,0,0,0
2014-01-30 09,6,2,4,0,0,0,0
2014-01-30 10,3,1,2,0,0,0,0
2014-01-30 11,3,1,2,0,0,0,0
2014-01-30 15,6,2,4,0,0,0,0
2014-01-30 16,3,1,2,0,0,0,0
2014-01-30 18,3,1,2,0,0,0,0
2014-01-30 19,3,1,2,0,0,0,0
2014-01-30 21,3,1,2,0,0,0,0
2014-01-30 22,3,1,2,0,0,0,0
2014-01-31 01,3,1,2,0,0,0,0
2014-01-31 12,3,1,2,0,0,0,0
2014-01-31 13,3,1,2,0,0,0,0
2014-01-31 15,6,2,4,0,0,0,0
2014-01-31 19,3,1,2,0,0,0,0
2014-01-31 20,3,1,2,0,0,0,0
2014-01-31 21,3,1,2,0,0,0,0
2014-02-01 12,3,1,2,0,0,0,0
2014-02-01 16,3,1,2,0,0,0,0
2014-02-02 02,3,1,2,0,0,0,0
2014-02-02 08,6,2,4,0,0,0,0
2014-02-02 09,3,1,2,0,0,0,0
2014-02-02 11,3,1,2,0,0,0,0
2014-02-02 13,3,1,2,0,0,0,0
2014-02-02 16,3,1,2,0,0,0,0
2014-02-02 17,3,1,2,0,0,0,0
2014-02-02 20,3,1,2,0,0,0,0
2014-02-02 21,3,1,2,0,0,0,0
2014-02-02 22,3,1,2,0,0,0,0
2014-02-02 23,3,1,2,0,0,0,0
2014-02-03 09,3,1,2,0,0,0,0
2014-02-03 13,3,1,2,0,0,0,0
2014-02-03 15,6,2,4,0,0,0,0
2014-02-03 16,6,2,4,0,0,0,0
2014-02-03 21,3,1,2,0,0,0,0
2014-02-03 23,3,1,2,0,0,0,0
2014-02-04 09,3,1,2,0,0,0,0
2014-02-04 10,3,1,2,0,0,0,0
2014-02-04 11,3,1,2,0,0,0,0
2014-02-11 09,3,1,2,0,0,0,0
2014-02-11 10,9,3,6,0,0,0,0
2014-02-11 11,18,6,12,0,0,0,0
2014-02-11 13,66,22,44,0,0,0,0
2014-02-11 14,21,7,14,0,0,0,0
2014-02-11 15,18,6,12,0,0,0,0
2014-02-11 16,6,2,4,0,0,0,0
2014-02-11 17,3,1,2,0,0,0,0
2014-02-11 18,9,3,6,0,0,0,0
2014-02-11 20,6,2,4,0,0,0,0
2014-02-11 21,3,1,2,0,0,0,0
2014-02-11 23,15,5,10,0,0,0,0
2014-02-12 00,9,3,6,0,0,0,0
2014-02-12 10,6,2,4,0,0,0,0
2014-02-12 11,12,4,8,0,0,0,0
2014-02-12 12,6,2,4,0,0,0,0
2014-02-12 13,6,2,4,0,0,0,0
2014-02-12 14,6,2,4,0,0,0,0
2014-02-12 15,9,3,6,0,0,0,0
2014-02-12 16,21,7,14,0,0,0,0
2014-02-12 17,12,4,8,0,0,0,0
2014-02-12 18,87,29,58,0,0,0,0
2014-02-12 19,171,57,114,0,0,0,0
2014-02-12 20,9,3,6,0,0,0,0
2014-02-12 22,18,6,12,0,0,0,0
2014-02-12 23,9,3,6,0,0,0,0
2014-02-13 06,9,3,6,0,0,0,0
2014-02-13 09,6,2,4,0,0,0,0
2014-02-13 10,15,5,10,0,0,0,0
2014-02-13 11,6,2,4,0,0,0,0
2014-02-13 12,15,5,10,0,0,0,0
2014-02-13 13,9,3,6,0,0,0,0
2014-02-13 14,3,1,2,0,0,0,0
2014-02-13 15,39,13,26,0,0,0,0
2014-02-13 16,93,31,62,0,0,0,0
2014-02-13 17,15,5,10,0,0,0,0
2014-02-13 18,6,2,4,0,0,0,0
2014-02-13 19,3,1,2,0,0,0,0
2014-02-13 20,3,1,2,0,0,0,0
2014-02-13 21,3,1,2,0,0,0,0
2014-02-13 22,6,2,4,0,0,0,0
2014-02-13 23,105,35,70,0,0,0,0
2014-02-14 00,3,1,2,0,0,0,0
2014-02-14 10,3,1,2,0,0,0,0
2014-02-14 11,6,2,4,0,0,0,0
2014-02-14 12,3,1,2,0,0,0,0
2014-02-14 13,69,23,46,0,0,0,0
2014-02-14 14,102,34,68,0,0,0,0
2014-02-14 15,6,2,4,0,0,0,0
2014-02-14 16,3,1,2,0,0,0,0
2014-02-14 17,163,55,108,0,0,0,0
2014-02-14 18,24,8,16,0,0,0,0
2014-02-14 19,9,3,6,0,0,0,0
2014-02-14 20,9,3,6,0,0,0,0
2014-02-14 21,6,2,4,0,0,0,0
2014-02-14 22,12,4,8,0,0,0,0
2014-02-14 23,6,2,4,0,0,0,0
2014-02-15 00,3,1,2,0,0,0,0
2014-02-15 03,15,5,10,0,0,0,0
2014-02-15 08,3,1,2,0,0,0,0
2014-02-15 10,6,2,4,0,0,0,0
2014-02-15 11,15,5,10,0,0,0,0
2014-02-15 13,15,5,10,0,0,0,0
2014-02-15 16,3,1,2,0,0,0,0
2014-02-15 17,3,1,2,0,0,0,0
2014-02-15 18,3,1,2,0,0,0,0
2014-02-15 19,3,1,2,0,0,0,0
2014-02-15 20,3,1,2,0,0,0,0
2014-02-15 21,3,1,2,0,0,0,0
2014-02-15 22,9,3,6,0,0,0,0
2014-02-15 23,9,3,6,0,0,0,0
2014-02-16 00,9,3,6,0,0,0,0
2014-02-16 01,12,4,8,0,0,0,0
2014-02-16 09,6,2,4,0,0,0,0
2014-02-16 10,9,3,6,0,0,0,0
2014-02-16 11,6,2,4,0,0,0,0
2014-02-16 12,24,8,16,0,0,0,0
2014-02-16 13,63,21,42,0,0,0,0
2014-02-16 14,6,2,4,0,0,0,0
2014-02-16 15,3,1,2,0,0,0,0
2014-02-16 16,3,1,2,0,0,0,0
2014-02-16 17,6,2,4,0,0,0,0
2014-02-16 18,138,46,92,0,0,0,0
2014-02-16 19,54,18,36,0,0,0,0
2014-02-16 20,22,7,14,1,0,0,0
2014-02-16 21,21,7,14,0,0,0,0
2014-02-16 22,15,5,10,0,0,0,0
2014-02-16 23,18,6,12,0,0,0,0
2014-02-17 00,6,2,4,0,0,0,0
2014-02-17 01,3,1,2,0,0,0,0
2014-02-17 03,3,1,2,0,0,0,0
2014-02-17 09,6,2,4,0,0,0,0
2014-02-17 10,3,1,2,0,0,0,0
2014-02-17 11,39,13,26,0,0,0,0
2014-02-17 12,6,2,4,0,0,0,0
2014-02-17 13,18,6,12,0,0,0,0
2014-02-17 14,108,36,72,0,0,0,0
2014-02-17 15,15,5,10,0,0,0,0
2014-02-17 16,12,4,8,0,0,0,0
2014-02-17 17,12,4,8,0,0,0,0
2014-02-17 18,78,26,52,0,0,0,0
2014-02-17 19,57,19,38,0,0,0,0
2014-02-17 20,9,3,6,0,0,0,0
2014-02-17 21,12,4,8,0,0,0,0
2014-02-17 22,9,3,6,0,0,0,0
2014-02-17 23,84,28,56,0,0,0,0
2014-02-18 00,84,28,56,0,0,0,0
2014-02-18 08,3,1,2,0,0,0,0
2014-02-18 10,12,4,8,0,0,0,0
2014-02-18 11,9,3,6,0,0,0,0
2014-02-18 12,24,8,16,0,0,0,0
2014-02-18 13,57,19,38,0,0,0,0
2014-02-18 14,24,8,16,0,0,0,0
2014-02-18 15,9,3,6,0,0,0,0
2014-02-18 16,6,2,4,0,0,0,0
2014-02-18 17,30,10,20,0,0,0,0
2014-02-18 18,78,26,52,0,0,0,0
2014-02-18 19,18,6,12,0,0,0,0
2014-02-18 20,33,11,22,0,0,0,0
2014-02-18 21,33,11,22,0,0,0,0
2014-02-18 22,81,27,54,0,0,0,0
2014-02-18 23,84,28,56,0,0,0,0
2014-02-19 00,36,12,24,0,0,0,0
2014-02-19 08,3,1,2,0,0,0,0
2014-02-19 09,6,2,4,0,0,0,0
2014-02-19 10,9,3,6,0,0,0,0
2014-02-19 11,12,4,8,0,0,0,0
2014-02-19 12,123,41,82,0,0,0,0
2014-02-19 13,126,42,84,0,0,0,0
2014-02-19 14,12,4,8,0,0,0,0
2014-02-19 15,3,1,2,0,0,0,0
2014-02-19 16,9,3,6,0,0,0,0
2014-02-19 17,9,3,6,0,0,0,0
2014-02-19 18,15,5,10,0,0,0,0
2014-02-19 19,9,3,6,0,0,0,0
2014-02-19 20,24,8,16,0,0,0,0
2014-02-19 21,69,23,46,0,0,0,0
2014-02-19 22,15,5,10,0,0,0,0
2014-02-19 23,9,3,6,0,0,0,0
2014-02-20 00,6,2,4,0,0,0,0
2014-02-20 03,3,1,2,0,0,0,0
2014-02-20 04,6,2,4,0,0,0,0
2014-02-20 07,3,1,2,0,0,0,0
2014-02-20 08,3,1,2,0,0,0,0
2014-02-20 09,12,4,8,0,0,0,0
2014-02-20 10,117,39,78,0,0,0,0
2014-02-20 11,9,3,6,0,0,0,0
2014-02-20 12,15,5,10,0,0,0,0
2014-02-20 13,21,7,14,0,0,0,0
2014-02-20 14,9,3,6,0,0,0,0
2014-02-20 15,114,38,76,0,0,0,0
2014-02-20 16,168,58,110,0,0,0,0
2014-02-20 17,12,4,8,0,0,0,0
2014-02-20 18,9,3,6,0,0,0,0
2014-02-20 19,39,13,26,0,0,0,0
2014-02-20 20,126,42,84,0,0,0,0
2014-02-20 21,27,9,18,0,0,0,0
2014-02-20 22,15,5,10,0,0,0,0
2014-02-20 23,18,6,12,0,0,0,0
2014-02-21 00,18,6,12,0,0,0,0
2014-02-21 05,3,1,2,0,0,0,0
2014-02-21 09,6,2,4,0,0,0,0
2014-02-21 10,111,37,74,0,0,0,0
2014-02-21 11,66,22,44,0,0,0,0
2014-02-21 12,18,6,12,0,0,0,0
2014-02-21 13,69,23,46,0,0,0,0
2014-02-21 14,114,38,76,0,0,0,0
2014-02-21 15,33,11,22,0,0,0,0
2014-02-21 16,6,2,4,0,0,0,0
2014-02-21 17,21,7,14,0,0,0,0
2014-02-21 18,13,5,8,0,0,0,0
2014-02-21 19,3,1,2,0,0,0,0
2014-02-21 21,3,1,2,0,0,0,0
2014-02-21 22,12,4,8,0,0,0,0
2014-02-21 23,30,10,20,0,0,0,0
2014-02-22 00,6,2,4,0,0,0,0
2014-02-22 09,90,30,60,0,0,0,0
2014-02-22 10,78,26,52,0,0,0,0
2014-02-22 11,15,5,10,0,0,0,0
2014-02-22 13,6,2,4,0,0,0,0
2014-02-22 14,3,1,2,0,0,0,0
2014-02-22 15,6,2,4,0,0,0,0
2014-02-22 17,75,25,50,0,0,0,0
2014-02-22 19,63,21,42,0,0,0,0
2014-02-22 21,15,5,10,0,0,0,0
2014-02-22 22,6,2,4,0,0,0,0
2014-02-23 09,6,2,4,0,0,0,0
2014-02-23 10,18,6,12,0,0,0,0
2014-02-23 11,12,4,8,0,0,0,0
2014-02-23 12,6,2,4,0,0,0,0
2014-02-23 13,3,1,2,0,0,0,0
2014-02-23 14,18,6,12,0,0,0,0
2014-02-23 15,9,3,6,0,0,0,0
2014-02-23 16,24,8,16,0,0,0,0
2014-02-23 17,6,2,4,0,0,0,0
2014-02-23 18,3,1,2,0,0,0,0
2014-02-23 19,9,3,6,0,0,0,0
2014-02-23 21,27,9,18,0,0,0,0
2014-02-23 23,63,21,42,0,0,0,0
2014-02-24 00,6,2,4,0,0,0,0
2014-02-24 09,18,6,12,0,0,0,0
2014-02-24 10,30,10,20,0,0,0,0
2014-02-24 11,9,3,6,0,0,0,0
2014-02-24 12,33,11,22,0,0,0,0
2014-02-24 15,6,2,4,0,0,0,0
2014-02-24 16,15,5,10,0,0,0,0
2014-02-24 17,15,5,10,0,0,0,0
2014-02-24 18,9,3,6,0,0,0,0
2014-02-24 19,3,1,2,0,0,0,0
2014-02-24 20,6,2,4,0,0,0,0
2014-02-24 21,3,1,2,0,0,0,0
2014-02-25 10,6,2,4,0,0,0,0
2014-02-25 11,3,1,2,0,0,0,0
2014-02-25 22,3,1,2,0,0,0,0
2014-02-27 16,3,1,2,0,0,0,0
2014-02-27 19,3,1,2,0,0,0,0
2014-02-28 19,3,1,2,0,0,0,0
2014-03-01 08,3,1,2,0,0,0,0
2014-03-01 10,3,1,2,0,0,0,0
2014-03-01 12,3,1,2,0,0,0,0
2014-03-02 09,3,1,2,0,0,0,0
2014-03-03 15,3,1,2,0,0,0,0
2014-03-03 17,3,1,2,0,0,0,0
