date,ALL,A,NS,CNAME,PTR,TXT,AAAA
2014-01-07 17,129,43,86,0,0,0,0
2014-01-07 18,156,52,104,0,0,0,0
2014-01-07 19,183,61,122,0,0,0,0
2014-01-07 20,159,53,106,0,0,0,0
2014-01-07 21,183,61,122,0,0,0,0
2014-01-07 22,156,52,104,0,0,0,0
2014-01-07 23,123,41,82,0,0,0,0
2014-01-08 00,66,22,44,0,0,0,0
2014-01-08 01,27,9,18,0,0,0,0
2014-01-08 02,6,2,4,0,0,0,0
2014-01-08 03,21,7,14,0,0,0,0
2014-01-08 05,6,2,4,0,0,0,0
2014-01-08 07,33,11,22,0,0,0,0
2014-01-08 08,99,33,66,0,0,0,0
2014-01-08 09,114,38,76,0,0,0,0
2014-01-08 10,129,43,86,0,0,0,0
2014-01-08 11,171,57,114,0,0,0,0
2014-01-08 12,195,65,130,0,0,0,0
2014-01-08 13,204,68,136,0,0,0,0
2014-01-08 14,186,62,124,0,0,0,0
2014-01-08 15,159,53,106,0,0,0,0
2014-01-08 16,234,78,156,0,0,0,0
2014-01-08 17,141,47,94,0,0,0,0
2014-01-08 18,81,27,54,0,0,0,0
2014-01-08 19,129,43,86,0,0,0,0
2014-01-08 20,81,27,54,0,0,0,0
2014-01-08 21,114,38,76,0,0,0,0
2014-01-08 22,87,29,58,0,0,0,0
2014-01-08 23,66,22,44,0,0,0,0
2014-01-09 00,30,10,20,0,0,0,0
2014-01-09 01,15,5,10,0,0,0,0
2014-01-09 02,15,5,10,0,0,0,0
2014-01-09 03,9,3,6,0,0,0,0
2014-01-09 04,3,1,2,0,0,0,0
2014-01-09 05,9,3,6,0,0,0,0
2014-01-09 06,3,1,2,0,0,0,0
2014-01-09 07,24,8,16,0,0,0,0
2014-01-09 08,69,23,46,0,0,0,0
2014-01-09 09,132,44,88,0,0,0,0
2014-01-09 10,128,42,86,0,0,0,0
2014-01-09 11,78,26,52,0,0,0,0
2014-01-09 12,117,39,78,0,0,0,0
2014-01-09 13,114,38,76,0,0,0,0
2014-01-09 14,174,58,116,0,0,0,0
2014-01-09 15,150,50,100,0,0,0,0
2014-01-09 16,129,43,86,0,0,0,0
2014-01-09 17,83,27,56,0,0,0,0
2014-01-09 18,150,50,100,0,0,0,0
2014-01-09 19,96,32,64,0,0,0,0
2014-01-09 20,114,38,76,0,0,0,0
2014-01-09 21,123,41,82,0,0,0,0
2014-01-09 22,156,52,104,0,0,0,0
2014-01-09 23,57,19,38,0,0,0,0
2014-01-10 00,30,10,20,0,0,0,0
2014-01-10 01,18,6,12,0,0,0,0
2014-01-10 02,24,8,16,0,0,0,0
2014-01-10 03,3,1,2,0,0,0,0
2014-01-10 04,3,1,2,0,0,0,0
2014-01-10 05,3,1,2,0,0,0,0
2014-01-10 06,6,2,4,0,0,0,0
2014-01-10 07,18,6,12,0,0,0,0
2014-01-10 08,105,35,70,0,0,0,0
2014-01-10 09,159,53,106,0,0,0,0
2014-01-10 10,153,51,102,0,0,0,0
2014-01-10 11,141,47,94,0,0,0,0
2014-01-10 12,104,34,70,0,0,0,0
2014-01-10 13,171,57,114,0,0,0,0
2014-01-10 14,171,57,114,0,0,0,0
2014-01-10 15,138,46,92,0,0,0,0
2014-01-10 16,183,61,122,0,0,0,0
2014-01-10 17,150,50,100,0,0,0,0
2014-01-10 18,117,39,78,0,0,0,0
2014-01-10 19,153,51,102,0,0,0,0
2014-01-10 20,186,62,124,0,0,0,0
2014-01-10 21,150,50,100,0,0,0,0
2014-01-10 22,123,41,82,0,0,0,0
2014-01-10 23,72,24,48,0,0,0,0
2014-01-11 00,69,23,46,0,0,0,0
2014-01-11 01,15,5,10,0,0,0,0
2014-01-11 02,6,2,4,0,0,0,0
2014-01-11 03,6,2,4,0,0,0,0
2014-01-11 04,3,1,2,0,0,0,0
2014-01-11 05,3,1,2,0,0,0,0
2014-01-11 06,3,1,2,0,0,0,0
2014-01-11 07,24,8,16,0,0,0,0
2014-01-11 08,15,5,10,0,0,0,0
2014-01-11 09,132,44,88,0,0,0,0
2014-01-11 10,174,58,116,0,0,0,0
2014-01-11 11,117,39,78,0,0,0,0
2014-01-11 12,90,30,60,0,0,0,0
2014-01-11 13,90,30,60,0,0,0,0
2014-01-11 14,120,40,80,0,0,0,0
2014-01-11 20,66,22,44,0,0,0,0
2014-01-11 21,90,30,60,0,0,0,0
2014-01-11 23,66,22,44,0,0,0,0
2014-01-12 00,6,2,4,0,0,0,0
2014-01-12 01,3,1,2,0,0,0,0
2014-01-12 02,9,3,6,0,0,0,0
2014-01-12 03,6,2,4,0,0,0,0
2014-01-12 04,5,1,4,0,0,0,0
2014-01-12 05,15,5,10,0,0,0,0
2014-01-12 06,27,9,18,0,0,0,0
2014-01-12 07,3,1,2,0,0,0,0
2014-01-12 08,6,2,4,0,0,0,0
2014-01-12 09,39,13,26,0,0,0,0
2014-01-12 10,51,17,34,0,0,0,0
2014-01-12 11,12,4,8,0,0,0,0
2014-01-12 12,48,16,32,0,0,0,0
2014-01-12 13,39,13,26,0,0,0,0
2014-01-12 14,114,38,76,0,0,0,0
2014-01-12 15,54,18,36,0,0,0,0
2014-01-12 16,48,16,32,0,0,0,0
2014-01-12 17,24,8,16,0,0,0,0
2014-01-12 18,63,21,42,0,0,0,0
2014-01-12 19,39,13,26,0,0,0,0
2014-01-12 20,48,16,32,0,0,0,0
2014-01-12 21,36,12,24,0,0,0,0
2014-01-12 22,15,5,10,0,0,0,0
2014-01-12 23,24,8,16,0,0,0,0
2014-01-13 00,40,12,28,0,0,0,0
2014-01-13 01,9,3,6,0,0,0,0
2014-01-13 02,9,3,6,0,0,0,0
2014-01-13 03,21,7,14,0,0,0,0
2014-01-13 04,3,1,2,0,0,0,0
2014-01-13 07,18,6,12,0,0,0,0
2014-01-13 08,42,14,28,0,0,0,0
2014-01-13 09,81,27,54,0,0,0,0
2014-01-13 10,89,29,60,0,0,0,0
2014-01-13 11,48,16,32,0,0,0,0
2014-01-13 12,60,20,40,0,0,0,0
2014-01-13 13,48,16,32,0,0,0,0
2014-01-13 14,42,14,28,0,0,0,0
2014-01-13 15,72,24,48,0,0,0,0
2014-01-13 16,129,43,86,0,0,0,0
2014-01-13 17,129,43,86,0,0,0,0
2014-01-13 18,96,32,64,0,0,0,0
2014-01-13 19,143,47,96,0,0,0,0
2014-01-13 20,75,25,50,0,0,0,0
2014-01-13 21,90,30,60,0,0,0,0
2014-01-13 22,65,21,44,0,0,0,0
2014-01-13 23,78,26,52,0,0,0,0
2014-01-14 00,18,6,12,0,0,0,0
2014-01-14 01,21,7,14,0,0,0,0
2014-01-14 02,9,3,6,0,0,0,0
2014-01-14 03,12,4,8,0,0,0,0
2014-01-14 05,6,2,4,0,0,0,0
2014-01-14 06,3,1,2,0,0,0,0
2014-01-14 07,30,10,20,0,0,0,0
2014-01-14 08,105,35,70,0,0,0,0
2014-01-14 09,138,46,92,0,0,0,0
2014-01-14 10,159,53,106,0,0,0,0
2014-01-14 11,149,49,100,0,0,0,0
2014-01-14 12,87,29,58,0,0,0,0
2014-01-14 13,87,29,58,0,0,0,0
2014-01-14 14,132,44,88,0,0,0,0
2014-01-14 15,189,63,126,0,0,0,0
2014-01-14 16,105,35,70,0,0,0,0
2014-01-14 17,186,62,124,0,0,0,0
2014-01-14 18,149,49,100,0,0,0,0
2014-01-14 19,138,46,92,0,0,0,0
2014-01-14 20,90,30,60,0,0,0,0
2014-01-14 21,138,46,92,0,0,0,0
2014-01-14 22,78,26,52,0,0,0,0
2014-01-14 23,108,36,72,0,0,0,0
2014-01-15 00,57,19,38,0,0,0,0
2014-01-15 01,21,7,14,0,0,0,0
2014-01-15 02,21,7,14,0,0,0,0
2014-01-15 03,12,4,8,0,0,0,0
2014-01-15 04,3,1,2,0,0,0,0
2014-01-15 05,3,1,2,0,0,0,0
2014-01-15 06,6,2,4,0,0,0,0
2014-01-15 07,21,7,14,0,0,0,0
2014-01-15 08,96,32,64,0,0,0,0
2014-01-15 09,138,46,92,0,0,0,0
2014-01-15 10,101,33,68,0,0,0,0
2014-01-15 11,140,46,94,0,0,0,0
2014-01-15 12,122,40,82,0,0,0,0
2014-01-15 13,89,29,60,0,0,0,0
2014-01-15 14,105,35,70,0,0,0,0
2014-01-15 15,155,51,104,0,0,0,0
2014-01-15 16,71,23,48,0,0,0,0
2014-01-15 17,64,20,44,0,0,0,0
2014-01-15 18,69,21,48,0,0,0,0
2014-01-15 20,70,22,48,0,0,0,0
2014-01-15 21,115,35,80,0,0,0,0
2014-01-15 22,108,36,72,0,0,0,0
2014-01-15 23,57,19,38,0,0,0,0
2014-01-16 00,81,27,54,0,0,0,0
2014-01-16 01,12,4,8,0,0,0,0
2014-01-16 02,29,9,20,0,0,0,0
2014-01-16 03,3,1,2,0,0,0,0
2014-01-16 05,6,2,4,0,0,0,0
2014-01-16 06,11,3,8,0,0,0,0
2014-01-16 07,27,9,18,0,0,0,0
2014-01-16 08,77,25,52,0,0,0,0
2014-01-16 09,107,35,72,0,0,0,0
2014-01-16 10,124,40,84,0,0,0,0
2014-01-16 11,78,26,52,0,0,0,0
2014-01-16 12,173,57,116,0,0,0,0
2014-01-16 13,98,32,66,0,0,0,0
2014-01-16 14,130,42,88,0,0,0,0
2014-01-16 15,161,53,108,0,0,0,0
2014-01-16 16,183,61,122,0,0,0,0
2014-01-16 17,89,29,60,0,0,0,0
2014-01-16 18,93,31,62,0,0,0,0
2014-01-16 19,132,44,88,0,0,0,0
2014-01-16 20,102,34,68,0,0,0,0
2014-01-16 21,159,53,106,0,0,0,0
2014-01-16 22,71,23,48,0,0,0,0
2014-01-16 23,93,31,62,0,0,0,0
2014-01-17 00,23,7,16,0,0,0,0
2014-01-17 01,8,2,6,0,0,0,0
2014-01-17 02,11,3,8,0,0,0,0
2014-01-17 03,12,4,8,0,0,0,0
2014-01-17 04,29,9,20,0,0,0,0
2014-01-17 06,6,2,4,0,0,0,0
2014-01-17 07,20,6,14,0,0,0,0
2014-01-17 08,53,17,36,0,0,0,0
2014-01-17 09,84,26,58,0,0,0,0
2014-01-17 10,156,52,104,0,0,0,0
2014-01-17 11,120,40,80,0,0,0,0
2014-01-17 12,141,47,94,0,0,0,0
2014-01-17 13,80,26,54,0,0,0,0
2014-01-17 14,117,39,78,0,0,0,0
2014-01-17 15,147,49,98,0,0,0,0
2014-01-17 16,198,66,132,0,0,0,0
2014-01-17 17,45,15,30,0,0,0,0
2014-01-17 18,9,3,6,0,0,0,0
2014-01-17 19,9,3,6,0,0,0,0
2014-01-17 20,15,5,10,0,0,0,0
2014-01-17 21,18,6,12,0,0,0,0
2014-01-17 22,12,4,8,0,0,0,0
2014-01-17 23,3,1,2,0,0,0,0
2014-01-18 00,3,1,2,0,0,0,0
2014-01-18 01,6,2,4,0,0,0,0
2014-01-18 02,3,1,2,0,0,0,0
2014-01-18 03,6,2,4,0,0,0,0
2014-01-18 04,26,8,18,0,0,0,0
2014-01-18 06,5,1,4,0,0,0,0
2014-01-18 07,9,3,6,0,0,0,0
2014-01-18 08,11,3,8,0,0,0,0
2014-01-18 09,39,13,26,0,0,0,0
2014-01-18 10,78,26,52,0,0,0,0
2014-01-18 11,72,24,48,0,0,0,0
2014-01-18 12,48,16,32,0,0,0,0
2014-01-18 13,84,28,56,0,0,0,0
2014-01-18 14,54,18,36,0,0,0,0
2014-01-18 15,99,33,66,0,0,0,0
2014-01-18 16,124,40,84,0,0,0,0
2014-01-18 17,71,23,48,0,0,0,0
2014-01-18 18,50,16,34,0,0,0,0
2014-01-18 19,54,18,36,0,0,0,0
2014-01-18 20,54,18,36,0,0,0,0
2014-01-18 21,91,29,62,0,0,0,0
2014-01-18 22,117,39,78,0,0,0,0
2014-01-18 23,48,16,32,0,0,0,0
2014-01-19 00,41,13,28,0,0,0,0
2014-01-19 01,11,3,8,0,0,0,0
2014-01-19 02,6,2,4,0,0,0,0
2014-01-19 04,6,2,4,0,0,0,0
2014-01-19 06,5,1,4,0,0,0,0
2014-01-19 07,9,3,6,0,0,0,0
2014-01-19 08,15,5,10,0,0,0,0
2014-01-19 09,57,19,38,0,0,0,0
2014-01-19 10,51,17,34,0,0,0,0
2014-01-19 11,75,25,50,0,0,0,0
2014-01-19 12,50,16,34,0,0,0,0
2014-01-19 13,56,18,38,0,0,0,0
2014-01-19 14,83,27,56,0,0,0,0
2014-01-19 15,72,24,48,0,0,0,0
2014-01-19 16,66,22,44,0,0,0,0
2014-01-19 17,71,23,48,0,0,0,0
2014-01-19 18,54,18,36,0,0,0,0
2014-01-19 19,57,19,38,0,0,0,0
2014-01-19 20,56,18,38,0,0,0,0
2014-01-19 21,111,37,74,0,0,0,0
2014-01-19 22,69,23,46,0,0,0,0
2014-01-19 23,45,15,30,0,0,0,0
2014-01-20 00,15,5,10,0,0,0,0
2014-01-20 01,27,9,18,0,0,0,0
2014-01-20 02,6,2,4,0,0,0,0
2014-01-20 04,5,1,4,0,0,0,0
2014-01-20 05,11,3,8,0,0,0,0
2014-01-20 07,21,7,14,0,0,0,0
2014-01-20 08,48,16,32,0,0,0,0
2014-01-20 09,54,18,36,0,0,0,0
2014-01-20 10,107,35,72,0,0,0,0
2014-01-20 11,117,39,78,0,0,0,0
2014-01-20 12,74,24,50,0,0,0,0
2014-01-20 13,66,22,44,0,0,0,0
2014-01-20 14,60,20,40,0,0,0,0
2014-01-20 15,93,31,62,0,0,0,0
2014-01-20 16,108,36,72,0,0,0,0
2014-01-20 17,66,22,44,0,0,0,0
2014-01-20 18,90,30,60,0,0,0,0
2014-01-20 19,39,13,26,0,0,0,0
2014-01-20 20,30,10,20,0,0,0,0
2014-01-20 21,42,14,28,0,0,0,0
2014-01-20 22,60,20,40,0,0,0,0
2014-01-20 23,24,8,16,0,0,0,0
2014-01-21 00,21,7,14,0,0,0,0
2014-01-21 01,15,5,10,0,0,0,0
2014-01-21 02,315,105,210,0,0,0,0
2014-01-21 03,24,8,16,0,0,0,0
2014-01-21 04,3,1,2,0,0,0,0
2014-01-21 05,3,1,2,0,0,0,0
2014-01-21 06,3,1,2,0,0,0,0
2014-01-21 07,9,3,6,0,0,0,0
2014-01-21 08,27,9,18,0,0,0,0
2014-01-21 09,60,20,40,0,0,0,0
2014-01-21 10,42,14,28,0,0,0,0
2014-01-21 11,60,20,40,0,0,0,0
2014-01-21 12,87,29,58,0,0,0,0
2014-01-21 13,93,31,62,0,0,0,0
2014-01-21 14,24,8,16,0,0,0,0
2014-01-21 15,108,36,72,0,0,0,0
2014-01-21 16,135,45,90,0,0,0,0
2014-01-21 17,51,17,34,0,0,0,0
2014-01-21 18,60,20,40,0,0,0,0
2014-01-21 19,66,22,44,0,0,0,0
2014-01-21 20,84,28,56,0,0,0,0
2014-01-21 21,84,28,56,0,0,0,0
2014-01-21 22,72,24,48,0,0,0,0
2014-01-21 23,45,15,30,0,0,0,0
2014-01-22 00,60,20,40,0,0,0,0
2014-01-22 01,24,8,16,0,0,0,0
2014-01-22 02,9,3,6,0,0,0,0
2014-01-22 03,15,5,10,0,0,0,0
2014-01-22 04,495,165,330,0,0,0,0
2014-01-22 05,9,3,6,0,0,0,0
2014-01-22 06,15,5,10,0,0,0,0
2014-01-22 07,36,12,24,0,0,0,0
2014-01-22 08,48,16,32,0,0,0,0
2014-01-22 09,114,38,76,0,0,0,0
2014-01-22 10,81,27,54,0,0,0,0
2014-01-22 11,105,35,70,0,0,0,0
2014-01-22 12,48,16,32,0,0,0,0
2014-01-22 13,42,14,28,0,0,0,0
2014-01-22 14,48,16,32,0,0,0,0
2014-01-22 15,288,96,192,0,0,0,0
2014-01-22 16,54,18,36,0,0,0,0
2014-01-22 17,3,1,2,0,0,0,0
2014-01-22 18,12,4,8,0,0,0,0
2014-01-22 19,9,3,6,0,0,0,0
2014-01-22 20,39,13,26,0,0,0,0
2014-01-22 21,45,15,30,0,0,0,0
2014-01-22 22,33,11,22,0,0,0,0
2014-01-22 23,15,5,10,0,0,0,0
2014-01-23 00,39,13,26,0,0,0,0
2014-01-23 01,6,2,4,0,0,0,0
2014-01-23 02,6,2,4,0,0,0,0
2014-01-23 03,6,2,4,0,0,0,0
2014-01-23 05,3,1,2,0,0,0,0
2014-01-23 06,6,2,4,0,0,0,0
2014-01-23 07,12,4,8,0,0,0,0
2014-01-23 08,39,13,26,0,0,0,0
2014-01-23 09,39,13,26,0,0,0,0
2014-01-23 10,48,16,32,0,0,0,0
2014-01-23 11,102,34,68,0,0,0,0
2014-01-23 12,51,17,34,0,0,0,0
2014-01-23 13,51,17,34,0,0,0,0
2014-01-23 14,48,16,32,0,0,0,0
2014-01-23 15,264,88,176,0,0,0,0
2014-01-23 16,60,20,40,0,0,0,0
2014-01-23 17,39,13,26,0,0,0,0
2014-01-23 18,24,8,16,0,0,0,0
2014-01-23 19,36,12,24,0,0,0,0
2014-01-23 20,57,19,38,0,0,0,0
2014-01-23 21,45,15,30,0,0,0,0
2014-01-23 22,57,19,38,0,0,0,0
2014-01-23 23,21,7,14,0,0,0,0
2014-01-24 00,15,5,10,0,0,0,0
2014-01-24 02,45,15,30,0,0,0,0
2014-01-24 04,15,5,10,0,0,0,0
2014-01-24 05,12,4,8,0,0,0,0
2014-01-24 06,21,7,14,0,0,0,0
2014-01-24 07,15,5,10,0,0,0,0
2014-01-24 08,12,4,8,0,0,0,0
2014-01-24 09,36,12,24,0,0,0,0
2014-01-24 10,60,20,40,0,0,0,0
2014-01-24 11,69,23,46,0,0,0,0
2014-01-24 12,42,14,28,0,0,0,0
2014-01-24 13,75,25,50,0,0,0,0
2014-01-24 14,63,21,42,0,0,0,0
2014-01-24 15,54,18,36,0,0,0,0
2014-01-24 16,42,14,28,0,0,0,0
2014-01-24 17,57,19,38,0,0,0,0
2014-01-24 18,33,11,22,0,0,0,0
2014-01-24 19,57,19,38,0,0,0,0
2014-01-24 20,51,17,34,0,0,0,0
2014-01-24 21,39,13,26,0,0,0,0
2014-01-24 22,48,16,32,0,0,0,0
2014-01-24 23,27,9,18,0,0,0,0
2014-01-25 00,27,9,18,0,0,0,0
2014-01-25 01,18,6,12,0,0,0,0
2014-01-25 02,51,17,34,0,0,0,0
2014-01-25 03,3,1,2,0,0,0,0
2014-01-25 05,6,2,4,0,0,0,0
2014-01-25 07,9,3,6,0,0,0,0
2014-01-25 08,36,12,24,0,0,0,0
2014-01-25 09,21,7,14,0,0,0,0
2014-01-25 10,21,7,14,0,0,0,0
2014-01-25 11,36,12,24,0,0,0,0
2014-01-25 12,33,11,22,0,0,0,0
2014-01-25 13,30,10,20,0,0,0,0
2014-01-25 14,42,14,28,0,0,0,0
2014-01-25 15,18,6,12,0,0,0,0
2014-01-25 16,33,11,22,0,0,0,0
2014-01-25 17,36,12,24,0,0,0,0
2014-01-25 18,9,3,6,0,0,0,0
2014-01-25 19,84,28,56,0,0,0,0
2014-01-25 20,24,8,16,0,0,0,0
2014-01-25 21,48,16,32,0,0,0,0
2014-01-25 22,21,7,14,0,0,0,0
2014-01-25 23,24,8,16,0,0,0,0
2014-01-26 00,18,6,12,0,0,0,0
2014-01-26 01,21,7,14,0,0,0,0
2014-01-26 02,48,16,32,0,0,0,0
2014-01-26 03,3,1,2,0,0,0,0
2014-01-26 05,6,2,4,0,0,0,0
2014-01-26 07,6,2,4,0,0,0,0
2014-01-26 08,24,8,16,0,0,0,0
2014-01-26 09,30,10,20,0,0,0,0
2014-01-26 10,30,10,20,0,0,0,0
2014-01-26 11,45,15,30,0,0,0,0
2014-01-26 12,39,13,26,0,0,0,0
2014-01-26 13,45,15,30,0,0,0,0
2014-01-26 14,33,11,22,0,0,0,0
2014-01-26 15,24,8,16,0,0,0,0
2014-01-26 16,21,7,14,0,0,0,0
2014-01-26 17,24,8,16,0,0,0,0
2014-01-26 18,21,7,14,0,0,0,0
2014-01-26 19,39,13,26,0,0,0,0
2014-01-26 20,24,8,16,0,0,0,0
2014-01-26 21,45,15,30,0,0,0,0
2014-01-26 22,24,8,16,0,0,0,0
2014-01-26 23,39,13,26,0,0,0,0
2014-01-27 00,21,7,14,0,0,0,0
2014-01-27 01,15,5,10,0,0,0,0
2014-01-27 02,12,4,8,0,0,0,0
2014-01-27 03,12,4,8,0,0,0,0
2014-01-27 04,6,2,4,0,0,0,0
2014-01-27 05,3,1,2,0,0,0,0
2014-01-27 06,24,8,16,0,0,0,0
2014-01-27 07,15,5,10,0,0,0,0
2014-01-27 08,63,21,42,0,0,0,0
2014-01-27 09,21,7,14,0,0,0,0
2014-01-27 10,51,17,34,0,0,0,0
2014-01-27 11,30,10,20,0,0,0,0
2014-01-27 12,27,9,18,0,0,0,0
2014-01-27 13,15,5,10,0,0,0,0
2014-01-27 14,36,12,24,0,0,0,0
2014-01-27 15,21,7,14,0,0,0,0
2014-01-27 16,57,19,38,0,0,0,0
2014-01-27 17,47,15,32,0,0,0,0
2014-01-27 18,39,13,26,0,0,0,0
2014-01-27 19,24,8,16,0,0,0,0
2014-01-27 20,30,10,20,0,0,0,0
2014-01-27 21,39,13,26,0,0,0,0
2014-01-27 22,93,31,62,0,0,0,0
2014-01-27 23,33,11,22,0,0,0,0
2014-01-28 00,12,4,8,0,0,0,0
2014-01-28 01,9,3,6,0,0,0,0
2014-01-28 02,3,1,2,0,0,0,0
2014-01-28 03,9,3,6,0,0,0,0
2014-01-28 05,3,1,2,0,0,0,0
2014-01-28 06,3,1,2,0,0,0,0
2014-01-28 07,9,3,6,0,0,0,0
2014-01-28 08,27,9,18,0,0,0,0
2014-01-28 09,12,4,8,0,0,0,0
2014-01-28 10,66,22,44,0,0,0,0
2014-01-28 11,45,15,30,0,0,0,0
2014-01-28 12,33,11,22,0,0,0,0
2014-01-28 13,39,13,26,0,0,0,0
2014-01-28 14,21,7,14,0,0,0,0
2014-01-28 15,39,13,26,0,0,0,0
2014-01-28 16,24,8,16,0,0,0,0
2014-01-28 17,21,7,14,0,0,0,0
2014-01-28 18,24,8,16,0,0,0,0
2014-01-28 19,39,13,26,0,0,0,0
2014-01-28 20,33,11,22,0,0,0,0
2014-01-28 21,66,22,44,0,0,0,0
2014-01-28 22,54,18,36,0,0,0,0
2014-01-28 23,30,10,20,0,0,0,0
2014-01-29 00,6,2,4,0,0,0,0
2014-01-29 01,9,3,6,0,0,0,0
2014-01-29 03,6,2,4,0,0,0,0
2014-01-29 04,3,1,2,0,0,0,0
2014-01-29 05,6,2,4,0,0,0,0
2014-01-29 06,6,2,4,0,0,0,0
2014-01-29 07,12,4,8,0,0,0,0
2014-01-29 08,30,10,20,0,0,0,0
2014-01-29 09,21,7,14,0,0,0,0
2014-01-29 10,24,8,16,0,0,0,0
2014-01-29 11,18,6,12,0,0,0,0
2014-01-29 12,18,6,12,0,0,0,0
2014-01-29 13,27,9,18,0,0,0,0
2014-01-29 14,27,9,18,0,0,0,0
2014-01-29 15,24,8,16,0,0,0,0
2014-01-29 16,39,13,26,0,0,0,0
2014-01-29 17,6,2,4,0,0,0,0
2014-01-29 19,9,3,6,0,0,0,0
2014-01-29 20,18,6,12,0,0,0,0
2014-01-29 21,18,6,12,0,0,0,0
2014-01-29 22,6,2,4,0,0,0,0
2014-01-29 23,9,3,6,0,0,0,0
2014-01-30 00,6,2,4,0,0,0,0
2014-01-30 01,3,1,2,0,0,0,0
2014-01-30 02,6,2,4,0,0,0,0
2014-01-30 04,3,1,2,0,0,0,0
2014-01-30 08,5,1,4,0,0,0,0
2014-01-30 09,3,1,2,0,0,0,0
2014-01-30 10,6,2,4,0,0,0,0
2014-01-30 11,6,2,4,0,0,0,0
2014-01-30 13,12,4,8,0,0,0,0
2014-01-30 14,6,2,4,0,0,0,0
2014-01-30 15,9,3,6,0,0,0,0
2014-01-30 16,24,8,16,0,0,0,0
2014-01-30 17,18,6,12,0,0,0,0
2014-01-30 18,24,8,16,0,0,0,0
2014-01-30 19,12,4,8,0,0,0,0
2014-01-30 20,15,5,10,0,0,0,0
2014-01-30 21,15,5,10,0,0,0,0
2014-01-30 22,21,7,14,0,0,0,0
2014-01-30 23,12,4,8,0,0,0,0
2014-01-31 00,6,2,4,0,0,0,0
2014-01-31 01,6,2,4,0,0,0,0
2014-01-31 02,15,5,10,0,0,0,0
2014-01-31 03,6,2,4,0,0,0,0
2014-01-31 07,9,3,6,0,0,0,0
2014-01-31 09,15,5,10,0,0,0,0
2014-01-31 10,21,7,14,0,0,0,0
2014-01-31 11,9,3,6,0,0,0,0
2014-01-31 12,18,6,12,0,0,0,0
2014-01-31 13,12,4,8,0,0,0,0
2014-01-31 14,18,6,12,0,0,0,0
2014-01-31 15,12,4,8,0,0,0,0
2014-01-31 16,33,11,22,0,0,0,0
2014-01-31 17,9,3,6,0,0,0,0
2014-01-31 18,24,8,16,0,0,0,0
2014-01-31 19,21,7,14,0,0,0,0
2014-01-31 20,9,3,6,0,0,0,0
2014-01-31 21,36,12,24,0,0,0,0
2014-01-31 22,57,19,38,0,0,0,0
2014-01-31 23,15,5,10,0,0,0,0
2014-02-01 00,18,6,12,0,0,0,0
2014-02-01 01,12,4,8,0,0,0,0
2014-02-01 02,3,1,2,0,0,0,0
2014-02-01 03,6,2,4,0,0,0,0
2014-02-01 07,3,1,2,0,0,0,0
2014-02-01 08,6,2,4,0,0,0,0
2014-02-01 09,33,11,22,0,0,0,0
2014-02-01 10,36,12,24,0,0,0,0
2014-02-01 11,30,10,20,0,0,0,0
2014-02-01 12,9,3,6,0,0,0,0
2014-02-01 13,6,2,4,0,0,0,0
2014-02-01 14,9,3,6,0,0,0,0
2014-02-01 15,9,3,6,0,0,0,0
2014-02-01 16,9,3,6,0,0,0,0
2014-02-01 17,12,4,8,0,0,0,0
2014-02-01 18,6,2,4,0,0,0,0
2014-02-01 19,15,5,10,0,0,0,0
2014-02-01 20,18,6,12,0,0,0,0
2014-02-01 21,30,10,20,0,0,0,0
2014-02-01 22,27,9,18,0,0,0,0
2014-02-01 23,21,7,14,0,0,0,0
2014-02-02 00,9,3,6,0,0,0,0
2014-02-02 01,3,1,2,0,0,0,0
2014-02-02 02,6,2,4,0,0,0,0
2014-02-02 03,3,1,2,0,0,0,0
2014-02-02 04,3,1,2,0,0,0,0
2014-02-02 05,3,1,2,0,0,0,0
2014-02-02 06,3,1,2,0,0,0,0
2014-02-02 07,6,2,4,0,0,0,0
2014-02-02 08,12,4,8,0,0,0,0
2014-02-02 09,9,3,6,0,0,0,0
2014-02-02 10,35,11,24,0,0,0,0
2014-02-02 11,42,14,28,0,0,0,0
2014-02-02 12,21,7,14,0,0,0,0
2014-02-02 13,12,4,8,0,0,0,0
2014-02-02 14,15,5,10,0,0,0,0
2014-02-02 15,30,10,20,0,0,0,0
2014-02-02 16,24,8,16,0,0,0,0
2014-02-02 17,21,7,14,0,0,0,0
2014-02-02 18,21,7,14,0,0,0,0
2014-02-02 19,27,9,18,0,0,0,0
2014-02-02 20,39,13,26,0,0,0,0
2014-02-02 21,33,11,22,0,0,0,0
2014-02-02 22,21,7,14,0,0,0,0
2014-02-02 23,69,23,46,0,0,0,0
2014-02-03 00,12,4,8,0,0,0,0
2014-02-03 01,24,8,16,0,0,0,0
2014-02-03 02,3,1,2,0,0,0,0
2014-02-03 04,3,1,2,0,0,0,0
2014-02-03 06,12,4,8,0,0,0,0
2014-02-03 07,3,1,2,0,0,0,0
2014-02-03 08,6,2,4,0,0,0,0
2014-02-03 09,15,5,10,0,0,0,0
2014-02-03 10,12,4,8,0,0,0,0
2014-02-03 11,21,7,14,0,0,0,0
2014-02-03 12,15,5,10,0,0,0,0
2014-02-03 13,15,5,10,0,0,0,0
2014-02-03 14,21,7,14,0,0,0,0
2014-02-03 15,21,7,14,0,0,0,0
2014-02-03 16,15,5,10,0,0,0,0
2014-02-03 17,3,1,2,0,0,0,0
2014-02-03 18,15,5,10,0,0,0,0
2014-02-03 19,15,5,10,0,0,0,0
2014-02-03 20,45,15,30,0,0,0,0
2014-02-03 21,21,7,14,0,0,0,0
2014-02-03 22,21,7,14,0,0,0,0
2014-02-03 23,24,8,16,0,0,0,0
2014-02-04 00,15,5,10,0,0,0,0
2014-02-04 01,30,10,20,0,0,0,0
2014-02-04 02,27,9,18,0,0,0,0
2014-02-04 03,9,3,6,0,0,0,0
2014-02-04 04,3,1,2,0,0,0,0
2014-02-04 06,3,1,2,0,0,0,0
2014-02-04 07,6,2,4,0,0,0,0
2014-02-04 09,6,2,4,0,0,0,0
2014-02-04 10,6,2,4,0,0,0,0
2014-02-04 11,15,5,10,0,0,0,0
2014-02-11 09,3,1,2,0,0,0,0
2014-02-11 10,12,4,8,0,0,0,0
2014-02-11 11,27,9,18,0,0,0,0
2014-02-11 12,6,2,4,0,0,0,0
2014-02-11 13,12,4,8,0,0,0,0
2014-02-11 14,6,2,4,0,0,0,0
2014-02-11 15,12,4,8,0,0,0,0
2014-02-11 16,33,11,22,0,0,0,0
2014-02-11 17,18,6,12,0,0,0,0
2014-02-11 18,21,7,14,0,0,0,0
2014-02-11 19,15,5,10,0,0,0,0
2014-02-11 20,33,11,22,0,0,0,0
2014-02-11 21,33,11,22,0,0,0,0
2014-02-11 22,12,4,8,0,0,0,0
2014-02-11 23,15,5,10,0,0,0,0
2014-02-12 00,12,4,8,0,0,0,0
2014-02-12 01,12,4,8,0,0,0,0
2014-02-12 02,3,1,2,0,0,0,0
2014-02-12 05,3,1,2,0,0,0,0
2014-02-12 07,6,2,4,0,0,0,0
2014-02-12 08,21,7,14,0,0,0,0
2014-02-12 09,36,12,24,0,0,0,0
2014-02-12 10,42,14,28,0,0,0,0
2014-02-12 11,27,9,18,0,0,0,0
2014-02-12 12,24,8,16,0,0,0,0
2014-02-12 13,9,3,6,0,0,0,0
2014-02-12 14,30,10,20,0,0,0,0
2014-02-12 15,39,13,26,0,0,0,0
2014-02-12 16,36,12,24,0,0,0,0
2014-02-12 17,18,6,12,0,0,0,0
2014-02-12 18,24,8,16,0,0,0,0
2014-02-12 19,12,4,8,0,0,0,0
2014-02-12 20,63,21,42,0,0,0,0
2014-02-12 21,18,6,12,0,0,0,0
2014-02-12 22,27,9,18,0,0,0,0
2014-02-12 23,9,3,6,0,0,0,0
2014-02-13 00,6,2,4,0,0,0,0
2014-02-13 01,3,1,2,0,0,0,0
2014-02-13 04,3,1,2,0,0,0,0
2014-02-13 05,3,1,2,0,0,0,0
2014-02-13 07,3,1,2,0,0,0,0
2014-02-13 08,9,3,6,0,0,0,0
2014-02-13 09,18,6,12,0,0,0,0
2014-02-13 10,9,3,6,0,0,0,0
2014-02-13 11,15,5,10,0,0,0,0
2014-02-13 13,9,3,6,0,0,0,0
2014-02-13 14,57,19,38,0,0,0,0
2014-02-13 15,24,8,16,0,0,0,0
2014-02-13 16,18,6,12,0,0,0,0
2014-02-13 17,24,8,16,0,0,0,0
2014-02-13 18,6,2,4,0,0,0,0
2014-02-13 19,12,4,8,0,0,0,0
2014-02-13 20,24,8,16,0,0,0,0
2014-02-13 21,21,7,14,0,0,0,0
2014-02-13 22,9,3,6,0,0,0,0
2014-02-13 23,3,1,2,0,0,0,0
2014-02-14 00,12,4,8,0,0,0,0
2014-02-14 02,3,1,2,0,0,0,0
2014-02-14 08,3,1,2,0,0,0,0
2014-02-14 09,12,4,8,0,0,0,0
2014-02-14 10,18,6,12,0,0,0,0
2014-02-14 11,18,6,12,0,0,0,0
2014-02-14 12,21,7,14,0,0,0,0
2014-02-14 13,39,13,26,0,0,0,0
2014-02-14 14,15,5,10,0,0,0,0
2014-02-14 15,39,13,26,0,0,0,0
2014-02-14 16,21,7,14,0,0,0,0
2014-02-14 17,24,8,16,0,0,0,0
2014-02-14 18,57,19,38,0,0,0,0
2014-02-14 19,21,7,14,0,0,0,0
2014-02-14 20,36,12,24,0,0,0,0
2014-02-14 21,24,8,16,0,0,0,0
2014-02-14 22,24,8,16,0,0,0,0
2014-02-14 23,12,4,8,0,0,0,0
2014-02-15 00,9,3,6,0,0,0,0
2014-02-15 02,6,2,4,0,0,0,0
2014-02-15 05,3,1,2,0,0,0,0
2014-02-15 09,12,4,8,0,0,0,0
2014-02-15 10,21,7,14,0,0,0,0
2014-02-15 11,24,8,16,0,0,0,0
2014-02-15 12,21,7,14,0,0,0,0
2014-02-15 13,18,6,12,0,0,0,0
2014-02-15 14,15,5,10,0,0,0,0
2014-02-15 15,24,8,16,0,0,0,0
2014-02-15 16,51,17,34,0,0,0,0
2014-02-15 17,21,7,14,0,0,0,0
2014-02-15 18,42,14,28,0,0,0,0
2014-02-15 19,21,7,14,0,0,0,0
2014-02-15 20,24,8,16,0,0,0,0
2014-02-15 21,42,14,28,0,0,0,0
2014-02-15 22,33,11,22,0,0,0,0
2014-02-15 23,27,9,18,0,0,0,0
2014-02-16 00,24,8,16,0,0,0,0
2014-02-16 01,3,1,2,0,0,0,0
2014-02-16 02,39,13,26,0,0,0,0
2014-02-16 03,3,1,2,0,0,0,0
2014-02-16 05,3,1,2,0,0,0,0
2014-02-16 07,9,3,6,0,0,0,0
2014-02-16 08,9,3,6,0,0,0,0
2014-02-16 09,30,10,20,0,0,0,0
2014-02-16 10,27,9,18,0,0,0,0
2014-02-16 11,39,13,26,0,0,0,0
2014-02-16 12,21,7,14,0,0,0,0
2014-02-16 13,42,14,28,0,0,0,0
2014-02-16 14,45,15,30,0,0,0,0
2014-02-16 15,33,11,22,0,0,0,0
2014-02-16 16,42,14,28,0,0,0,0
2014-02-16 17,30,10,20,0,0,0,0
2014-02-16 18,39,13,26,0,0,0,0
2014-02-16 19,36,12,24,0,0,0,0
2014-02-16 20,24,8,16,0,0,0,0
2014-02-16 21,27,9,18,0,0,0,0
2014-02-16 22,21,7,14,0,0,0,0
2014-02-16 23,12,4,8,0,0,0,0
2014-02-17 00,6,2,4,0,0,0,0
2014-02-17 01,6,2,4,0,0,0,0
2014-02-17 02,3,1,2,0,0,0,0
2014-02-17 06,3,1,2,0,0,0,0
2014-02-17 07,15,5,10,0,0,0,0
2014-02-17 08,21,7,14,0,0,0,0
2014-02-17 09,30,10,20,0,0,0,0
2014-02-17 10,45,15,30,0,0,0,0
2014-02-17 11,63,21,42,0,0,0,0
2014-02-17 12,30,10,20,0,0,0,0
2014-02-17 13,30,10,20,0,0,0,0
2014-02-17 14,45,15,30,0,0,0,0
2014-02-17 15,45,15,30,0,0,0,0
2014-02-17 16,30,10,20,0,0,0,0
2014-02-17 17,39,13,26,0,0,0,0
2014-02-17 18,27,9,18,0,0,0,0
2014-02-17 19,54,18,36,0,0,0,0
2014-02-17 20,39,13,26,0,0,0,0
2014-02-17 21,27,9,18,0,0,0,0
2014-02-17 22,21,7,14,0,0,0,0
2014-02-17 23,15,5,10,0,0,0,0
2014-02-18 00,21,7,14,0,0,0,0
2014-02-18 01,51,17,34,0,0,0,0
2014-02-18 02,192,64,128,0,0,0,0
2014-02-18 07,6,2,4,0,0,0,0
2014-02-18 08,18,6,12,0,0,0,0
2014-02-18 09,39,13,26,0,0,0,0
2014-02-18 10,24,8,16,0,0,0,0
2014-02-18 11,12,4,8,0,0,0,0
2014-02-18 12,6,2,4,0,0,0,0
2014-02-18 13,12,4,8,0,0,0,0
2014-02-18 14,21,7,14,0,0,0,0
2014-02-18 15,12,4,8,0,0,0,0
2014-02-18 16,15,5,10,0,0,0,0
2014-02-18 17,30,10,20,0,0,0,0
2014-02-18 18,24,8,16,0,0,0,0
2014-02-18 19,57,19,38,0,0,0,0
2014-02-18 20,30,10,20,0,0,0,0
2014-02-18 21,21,7,14,0,0,0,0
2014-02-18 22,21,7,14,0,0,0,0
2014-02-18 23,6,2,4,0,0,0,0
2014-02-19 00,15,5,10,0,0,0,0
2014-02-19 01,36,12,24,0,0,0,0
2014-02-19 02,18,6,12,0,0,0,0
2014-02-19 07,9,3,6,0,0,0,0
2014-02-19 08,6,2,4,0,0,0,0
2014-02-19 09,24,8,16,0,0,0,0
2014-02-19 10,51,17,34,0,0,0,0
2014-02-19 11,18,6,12,0,0,0,0
2014-02-19 12,33,11,22,0,0,0,0
2014-02-19 13,18,6,12,0,0,0,0
2014-02-19 14,51,17,34,0,0,0,0
2014-02-19 15,75,25,50,0,0,0,0
2014-02-19 16,33,11,22,0,0,0,0
2014-02-19 17,33,11,22,0,0,0,0
2014-02-19 18,6,2,4,0,0,0,0
2014-02-19 19,24,8,16,0,0,0,0
2014-02-19 20,27,9,18,0,0,0,0
2014-02-19 21,9,3,6,0,0,0,0
2014-02-19 22,18,6,12,0,0,0,0
2014-02-19 23,18,6,12,0,0,0,0
2014-02-20 00,18,6,12,0,0,0,0
2014-02-20 01,42,14,28,0,0,0,0
2014-02-20 02,111,37,74,0,0,0,0
2014-02-20 03,33,11,22,0,0,0,0
2014-02-20 06,6,2,4,0,0,0,0
2014-02-20 07,3,1,2,0,0,0,0
2014-02-20 08,32,10,22,0,0,0,0
2014-02-20 09,51,17,34,0,0,0,0
2014-02-20 10,60,20,40,0,0,0,0
2014-02-20 11,54,18,36,0,0,0,0
2014-02-20 12,48,16,32,0,0,0,0
2014-02-20 13,27,9,18,0,0,0,0
2014-02-20 14,78,26,52,0,0,0,0
2014-02-20 15,81,27,54,0,0,0,0
2014-02-20 16,66,22,44,0,0,0,0
2014-02-20 17,48,16,32,0,0,0,0
2014-02-20 18,24,8,16,0,0,0,0
2014-02-20 19,75,25,50,0,0,0,0
2014-02-20 20,39,13,26,0,0,0,0
2014-02-20 21,45,15,30,0,0,0,0
2014-02-20 22,39,13,26,0,0,0,0
2014-02-20 23,24,8,16,0,0,0,0
2014-02-21 00,15,5,10,0,0,0,0
2014-02-21 01,21,7,14,0,0,0,0
2014-02-21 05,3,1,2,0,0,0,0
2014-02-21 07,9,3,6,0,0,0,0
2014-02-21 08,33,11,22,0,0,0,0
2014-02-21 09,54,18,36,0,0,0,0
2014-02-21 10,66,22,44,0,0,0,0
2014-02-21 11,72,24,48,0,0,0,0
2014-02-21 12,36,12,24,0,0,0,0
2014-02-21 13,30,10,20,0,0,0,0
2014-02-21 14,48,16,32,0,0,0,0
2014-02-21 15,63,21,42,0,0,0,0
2014-02-21 16,78,26,52,0,0,0,0
2014-02-21 17,78,26,52,0,0,0,0
2014-02-21 18,60,20,40,0,0,0,0
2014-02-21 19,57,19,38,0,0,0,0
2014-02-21 20,51,17,34,0,0,0,0
2014-02-21 21,63,21,42,0,0,0,0
2014-02-21 22,45,15,30,0,0,0,0
2014-02-21 23,27,9,18,0,0,0,0
2014-02-22 00,12,4,8,0,0,0,0
2014-02-22 03,6,2,4,0,0,0,0
2014-02-22 07,3,1,2,0,0,0,0
2014-02-22 08,18,6,12,0,0,0,0
2014-02-22 09,60,20,40,0,0,0,0
2014-02-22 10,90,30,60,0,0,0,0
2014-02-22 11,54,18,36,0,0,0,0
2014-02-22 12,51,17,34,0,0,0,0
2014-02-22 13,24,8,16,0,0,0,0
2014-02-22 14,51,17,34,0,0,0,0
2014-02-22 15,33,11,22,0,0,0,0
2014-02-22 16,51,17,34,0,0,0,0
2014-02-22 17,27,9,18,0,0,0,0
2014-02-22 18,84,28,56,0,0,0,0
2014-02-22 19,72,24,48,0,0,0,0
2014-02-22 20,96,32,64,0,0,0,0
2014-02-22 21,27,9,18,0,0,0,0
2014-02-22 22,54,18,36,0,0,0,0
2014-02-22 23,39,13,26,0,0,0,0
2014-02-23 00,6,2,4,0,0,0,0
2014-02-23 01,6,2,4,0,0,0,0
2014-02-23 02,3,1,2,0,0,0,0
2014-02-23 04,3,1,2,0,0,0,0
2014-02-23 05,6,2,4,0,0,0,0
2014-02-23 06,3,1,2,0,0,0,0
2014-02-23 07,3,1,2,0,0,0,0
2014-02-23 08,6,2,4,0,0,0,0
2014-02-23 09,42,14,28,0,0,0,0
2014-02-23 10,48,16,32,0,0,0,0
2014-02-23 11,15,5,10,0,0,0,0
2014-02-23 12,18,6,12,0,0,0,0
2014-02-23 13,45,15,30,0,0,0,0
2014-02-23 14,36,12,24,0,0,0,0
2014-02-23 15,39,13,26,0,0,0,0
2014-02-23 16,36,12,24,0,0,0,0
2014-02-23 17,36,12,24,0,0,0,0
2014-02-23 18,72,24,48,0,0,0,0
2014-02-23 19,39,13,26,0,0,0,0
2014-02-23 20,66,22,44,0,0,0,0
2014-02-23 21,60,20,40,0,0,0,0
2014-02-23 22,45,15,30,0,0,0,0
2014-02-23 23,15,5,10,0,0,0,0
2014-02-24 00,15,5,10,0,0,0,0
2014-02-24 02,3,1,2,0,0,0,0
2014-02-24 04,3,1,2,0,0,0,0
2014-02-24 06,3,1,2,0,0,0,0
2014-02-24 07,12,4,8,0,0,0,0
2014-02-24 08,48,16,32,0,0,0,0
2014-02-24 09,60,20,40,0,0,0,0
2014-02-24 10,132,44,88,0,0,0,0
2014-02-24 11,57,19,38,0,0,0,0
2014-02-24 12,45,15,30,0,0,0,0
2014-02-24 13,39,13,26,0,0,0,0
2014-02-24 14,45,15,30,0,0,0,0
2014-02-24 15,78,26,52,0,0,0,0
2014-02-24 16,102,34,68,0,0,0,0
2014-02-24 17,36,12,24,0,0,0,0
2014-02-24 18,33,11,22,0,0,0,0
2014-02-24 19,42,14,28,0,0,0,0
2014-02-24 20,54,18,36,0,0,0,0
2014-02-24 21,54,18,36,0,0,0,0
2014-02-24 22,57,19,38,0,0,0,0
2014-02-24 23,15,5,10,0,0,0,0
2014-02-25 00,30,10,20,0,0,0,0
2014-02-25 01,30,10,20,0,0,0,0
2014-02-25 03,3,1,2,0,0,0,0
2014-02-25 08,18,6,12,0,0,0,0
2014-02-25 09,36,12,24,0,0,0,0
2014-02-25 10,42,14,28,0,0,0,0
2014-02-25 11,33,11,22,0,0,0,0
2014-02-25 12,32,10,22,0,0,0,0
2014-02-25 13,12,4,8,0,0,0,0
2014-02-25 14,15,5,10,0,0,0,0
2014-02-25 15,27,9,18,0,0,0,0
2014-02-25 16,34,10,24,0,0,0,0
2014-02-25 17,83,27,56,0,0,0,0
2014-02-25 18,32,10,22,0,0,0,0
2014-02-25 19,19,5,14,0,0,0,0
2014-02-25 20,35,11,24,0,0,0,0
2014-02-25 21,35,11,24,0,0,0,0
2014-02-25 22,52,16,36,0,0,0,0
2014-02-25 23,15,5,10,0,0,0,0
2014-02-26 00,21,7,14,0,0,0,0
2014-02-26 01,9,3,6,0,0,0,0
2014-02-26 02,15,5,10,0,0,0,0
2014-02-26 05,3,1,2,0,0,0,0
2014-02-26 07,3,1,2,0,0,0,0
2014-02-26 08,24,8,16,0,0,0,0
2014-02-26 09,78,26,52,0,0,0,0
2014-02-26 10,90,30,60,0,0,0,0
2014-02-26 11,120,40,80,0,0,0,0
2014-02-26 12,63,21,42,0,0,0,0
2014-02-26 13,90,30,60,0,0,0,0
2014-02-26 14,63,21,42,0,0,0,0
2014-02-26 15,63,21,42,0,0,0,0
2014-02-26 16,147,49,98,0,0,0,0
2014-02-26 17,42,14,28,0,0,0,0
2014-02-26 18,60,20,40,0,0,0,0
2014-02-26 19,66,22,44,0,0,0,0
2014-02-26 20,63,21,42,0,0,0,0
2014-02-26 21,66,22,44,0,0,0,0
2014-02-26 22,60,20,40,0,0,0,0
2014-02-26 23,33,11,22,0,0,0,0
2014-02-27 00,15,5,10,0,0,0,0
2014-02-27 01,18,6,12,0,0,0,0
2014-02-27 02,3,1,2,0,0,0,0
2014-02-27 03,23,7,16,0,0,0,0
2014-02-27 07,9,3,6,0,0,0,0
2014-02-27 08,63,21,42,0,0,0,0
2014-02-27 09,66,22,44,0,0,0,0
2014-02-27 10,57,19,38,0,0,0,0
2014-02-27 11,60,20,40,0,0,0,0
2014-02-27 12,81,27,54,0,0,0,0
2014-02-27 13,81,27,54,0,0,0,0
2014-02-27 14,48,16,32,0,0,0,0
2014-02-27 15,111,37,74,0,0,0,0
2014-02-27 16,66,22,44,0,0,0,0
2014-02-27 17,75,25,50,0,0,0,0
2014-02-27 18,42,14,28,0,0,0,0
2014-02-27 19,81,27,54,0,0,0,0
2014-02-27 20,45,15,30,0,0,0,0
2014-02-27 21,39,13,26,0,0,0,0
2014-02-27 22,75,25,50,0,0,0,0
2014-02-27 23,66,22,44,0,0,0,0
2014-02-28 00,27,9,18,0,0,0,0
2014-02-28 01,3,1,2,0,0,0,0
2014-02-28 02,3,1,2,0,0,0,0
2014-02-28 04,3,1,2,0,0,0,0
2014-02-28 05,4,0,4,0,0,0,0
2014-02-28 07,12,4,8,0,0,0,0
2014-02-28 08,42,14,28,0,0,0,0
2014-02-28 09,69,23,46,0,0,0,0
2014-02-28 10,42,14,28,0,0,0,0
2014-02-28 11,36,12,24,0,0,0,0
2014-02-28 12,96,32,64,0,0,0,0
2014-02-28 13,33,11,22,0,0,0,0
2014-02-28 14,51,17,34,0,0,0,0
2014-02-28 15,120,40,80,0,0,0,0
2014-02-28 16,69,23,46,0,0,0,0
2014-02-28 17,33,11,22,0,0,0,0
2014-02-28 18,48,16,32,0,0,0,0
2014-02-28 19,57,19,38,0,0,0,0
2014-02-28 20,84,28,56,0,0,0,0
2014-02-28 21,54,18,36,0,0,0,0
2014-02-28 22,71,23,48,0,0,0,0
2014-02-28 23,33,11,22,0,0,0,0
2014-03-01 00,30,10,20,0,0,0,0
2014-03-01 01,12,4,8,0,0,0,0
2014-03-01 08,14,4,10,0,0,0,0
2014-03-01 09,18,6,12,0,0,0,0
2014-03-01 10,42,14,28,0,0,0,0
2014-03-01 11,36,12,24,0,0,0,0
2014-03-01 12,36,12,24,0,0,0,0
2014-03-01 13,39,13,26,0,0,0,0
2014-03-01 14,54,18,36,0,0,0,0
2014-03-01 15,36,12,24,0,0,0,0
2014-03-01 16,51,17,34,0,0,0,0
2014-03-01 17,36,12,24,0,0,0,0
2014-03-01 18,39,13,26,0,0,0,0
2014-03-01 19,57,19,38,0,0,0,0
2014-03-01 20,24,8,16,0,0,0,0
2014-03-01 21,63,21,42,0,0,0,0
2014-03-01 22,45,15,30,0,0,0,0
2014-03-01 23,63,21,42,0,0,0,0
2014-03-02 00,12,4,8,0,0,0,0
2014-03-02 01,9,3,6,0,0,0,0
2014-03-02 02,39,13,26,0,0,0,0
2014-03-02 03,252,84,168,0,0,0,0
2014-03-02 04,123,41,82,0,0,0,0
2014-03-02 07,3,1,2,0,0,0,0
2014-03-02 08,15,5,10,0,0,0,0
2014-03-02 09,39,13,26,0,0,0,0
2014-03-02 10,42,14,28,0,0,0,0
2014-03-02 11,12,4,8,0,0,0,0
2014-03-02 12,36,12,24,0,0,0,0
2014-03-02 13,45,15,30,0,0,0,0
2014-03-02 14,84,28,56,0,0,0,0
2014-03-02 15,33,11,22,0,0,0,0
2014-03-02 16,45,15,30,0,0,0,0
2014-03-02 17,24,8,16,0,0,0,0
2014-03-02 18,24,8,16,0,0,0,0
2014-03-02 19,36,12,24,0,0,0,0
2014-03-02 20,36,12,24,0,0,0,0
2014-03-02 21,57,19,38,0,0,0,0
2014-03-02 22,87,29,58,0,0,0,0
2014-03-02 23,18,6,12,0,0,0,0
2014-03-03 00,3,1,2,0,0,0,0
2014-03-03 01,9,3,6,0,0,0,0
2014-03-03 02,21,7,14,0,0,0,0
2014-03-03 03,102,34,68,0,0,0,0
2014-03-03 05,3,1,2,0,0,0,0
2014-03-03 06,3,1,2,0,0,0,0
2014-03-03 07,15,5,10,0,0,0,0
2014-03-03 08,24,8,16,0,0,0,0
2014-03-03 09,45,15,30,0,0,0,0
2014-03-03 10,39,13,26,0,0,0,0
2014-03-03 11,45,15,30,0,0,0,0
2014-03-03 12,60,20,40,0,0,0,0
2014-03-03 13,63,21,42,0,0,0,0
2014-03-03 14,81,27,54,0,0,0,0
2014-03-03 15,96,32,64,0,0,0,0
2014-03-03 16,75,25,50,0,0,0,0
2014-03-03 17,42,14,28,0,0,0,0
2014-03-03 18,36,12,24,0,0,0,0
2014-03-03 19,81,27,54,0,0,0,0
2014-03-03 20,66,22,44,0,0,0,0
2014-03-03 21,93,31,62,0,0,0,0
2014-03-03 22,72,24,48,0,0,0,0
2014-03-03 23,27,9,18,0,0,0,0
2014-03-04 00,23,7,16,0,0,0,0
2014-03-04 01,6,2,4,0,0,0,0
2014-03-04 02,18,6,12,0,0,0,0
2014-03-04 03,12,4,8,0,0,0,0
2014-03-04 04,6,2,4,0,0,0,0
2014-03-04 05,3,1,2,0,0,0,0
2014-03-04 07,15,5,10,0,0,0,0
2014-03-04 08,45,15,30,0,0,0,0
2014-03-04 09,78,26,52,0,0,0,0
2014-03-04 10,57,19,38,0,0,0,0
2014-03-04 11,51,17,34,0,0,0,0
2014-03-04 12,45,15,30,0,0,0,0
2014-03-04 13,57,19,38,0,0,0,0
2014-03-04 14,33,11,22,0,0,0,0
2014-03-04 15,27,9,18,0,0,0,0
2014-03-04 16,75,25,50,0,0,0,0
2014-03-04 17,21,7,14,0,0,0,0
2014-03-04 18,36,12,24,0,0,0,0
2014-03-04 19,15,5,10,0,0,0,0
2014-03-04 20,24,8,16,0,0,0,0
2014-03-04 21,27,9,18,0,0,0,0
2014-03-04 22,33,11,22,0,0,0,0
2014-03-04 23,18,6,12,0,0,0,0
2014-03-05 00,6,2,4,0,0,0,0
2014-03-05 01,3,1,2,0,0,0,0
2014-03-05 02,21,7,14,0,0,0,0
2014-03-05 05,3,1,2,0,0,0,0
2014-03-05 07,3,1,2,0,0,0,0
2014-03-05 08,15,5,10,0,0,0,0
2014-03-05 09,24,8,16,0,0,0,0
2014-03-05 10,21,7,14,0,0,0,0
2014-03-05 11,36,12,24,0,0,0,0
2014-03-05 12,51,17,34,0,0,0,0
2014-03-05 13,18,6,12,0,0,0,0
2014-03-05 14,30,10,20,0,0,0,0
2014-03-05 15,42,14,28,0,0,0,0
2014-03-05 16,54,18,36,0,0,0,0
2014-03-05 17,75,25,50,0,0,0,0
2014-03-05 18,72,24,48,0,0,0,0
2014-03-05 19,24,8,16,0,0,0,0
2014-03-05 20,21,7,14,0,0,0,0
2014-03-05 21,24,8,16,0,0,0,0
2014-03-05 22,30,10,20,0,0,0,0
2014-03-05 23,30,10,20,0,0,0,0
2014-03-06 00,3,1,2,0,0,0,0
2014-03-06 01,9,3,6,0,0,0,0
2014-03-06 02,6,2,4,0,0,0,0
2014-03-06 07,6,2,4,0,0,0,0
2014-03-06 08,12,4,8,0,0,0,0
2014-03-06 09,27,9,18,0,0,0,0
2014-03-06 10,33,11,22,0,0,0,0
2014-03-06 11,33,11,22,0,0,0,0
2014-03-06 12,21,7,14,0,0,0,0
2014-03-06 13,42,14,28,0,0,0,0
2014-03-06 14,63,21,42,0,0,0,0
2014-03-06 15,54,18,36,0,0,0,0
2014-03-06 16,45,15,30,0,0,0,0
2014-03-06 17,12,4,8,0,0,0,0
2014-03-06 18,15,5,10,0,0,0,0
2014-03-06 19,36,12,24,0,0,0,0
2014-03-06 20,12,4,8,0,0,0,0
2014-03-06 21,21,7,14,0,0,0,0
2014-03-06 22,45,15,30,0,0,0,0
2014-03-06 23,21,7,14,0,0,0,0
2014-03-07 00,18,6,12,0,0,0,0
