date,ALL,A,NS,CNAME,PTR,TXT,AAAA
2014-01-07 17,43,26,0,17,0,0,0
2014-01-07 18,12,3,0,9,0,0,0
2014-01-07 19,3,0,0,3,0,0,0
2014-01-07 20,15,3,0,12,0,0,0
2014-01-07 21,20,6,0,14,0,0,0
2014-01-07 22,32,20,0,12,0,0,0
2014-01-07 23,35,19,0,16,0,0,0
2014-01-08 08,19,18,0,1,0,0,0
2014-01-08 09,12,9,0,3,0,0,0
2014-01-08 10,23,20,0,3,0,0,0
2014-01-08 11,7,4,0,3,0,0,0
2014-01-08 12,29,11,0,18,0,0,0
2014-01-08 13,44,28,0,16,0,0,0
2014-01-08 14,38,33,0,5,0,0,0
2014-01-08 15,52,18,0,34,0,0,0
2014-01-08 16,26,8,0,18,0,0,0
2014-01-08 17,21,10,0,11,0,0,0
2014-01-08 18,32,15,0,17,0,0,0
2014-01-08 19,28,11,0,17,0,0,0
2014-01-08 20,69,38,0,31,0,0,0
2014-01-08 21,41,15,0,26,0,0,0
2014-01-08 22,8,4,0,4,0,0,0
2014-01-08 23,15,3,0,12,0,0,0
2014-01-09 00,10,0,0,10,0,0,0
2014-01-09 01,16,16,0,0,0,0,0
2014-01-09 03,1,0,0,1,0,0,0
2014-01-09 08,13,3,0,10,0,0,0
2014-01-09 09,9,3,0,6,0,0,0
2014-01-09 10,25,13,0,12,0,0,0
2014-01-09 11,20,14,0,6,0,0,0
2014-01-09 12,6,3,0,3,0,0,0
2014-01-09 13,34,19,0,15,0,0,0
2014-01-09 14,20,10,0,10,0,0,0
2014-01-09 15,14,6,0,8,0,0,0
2014-01-09 16,47,16,0,31,0,0,0
2014-01-09 17,32,10,0,22,0,0,0
2014-01-09 18,75,36,0,39,0,0,0
2014-01-09 19,14,4,0,10,0,0,0
2014-01-09 20,21,9,0,12,0,0,0
2014-01-09 22,33,13,0,20,0,0,0
2014-01-09 23,21,11,0,10,0,0,0
2014-01-10 00,19,3,0,16,0,0,0
2014-01-10 01,8,8,0,0,0,0,0
2014-01-10 02,8,8,0,0,0,0,0
2014-01-10 06,1,0,0,1,0,0,0
2014-01-10 08,32,8,0,24,0,0,0
2014-01-10 09,22,11,0,11,0,0,0
2014-01-10 10,37,8,0,29,0,0,0
2014-01-10 11,1,0,0,1,0,0,0
2014-01-10 12,10,8,0,2,0,0,0
2014-01-10 13,41,40,0,1,0,0,0
2014-01-10 14,17,14,0,3,0,0,0
2014-01-10 15,54,24,0,30,0,0,0
2014-01-10 16,24,9,0,15,0,0,0
2014-01-10 17,29,8,0,21,0,0,0
2014-01-10 18,68,37,0,31,0,0,0
2014-01-10 19,2,1,0,1,0,0,0
2014-01-10 20,18,5,0,13,0,0,0
2014-01-10 21,13,2,0,11,0,0,0
2014-01-10 22,9,9,0,0,0,0,0
2014-01-10 23,1,0,0,1,0,0,0
2014-01-11 04,8,8,0,0,0,0,0
2014-01-11 06,1,0,0,1,0,0,0
2014-01-11 08,4,4,0,0,0,0,0
2014-01-11 09,23,7,0,16,0,0,0
2014-01-11 10,39,6,0,33,0,0,0
2014-01-11 11,1,0,0,1,0,0,0
2014-01-11 12,19,6,0,13,0,0,0
2014-01-11 14,12,5,0,7,0,0,0
2014-01-11 20,15,7,0,8,0,0,0
2014-01-11 21,1,0,0,1,0,0,0
2014-01-11 23,1,0,0,1,0,0,0
2014-01-12 00,4,4,0,0,0,0,0
2014-01-12 08,1,1,0,0,0,0,0
2014-01-12 09,1,1,0,0,0,0,0
2014-01-12 12,4,4,0,0,0,0,0
2014-01-12 20,1,1,0,0,0,0,0
2014-01-12 22,4,4,0,0,0,0,0
2014-01-12 23,4,4,0,0,0,0,0
2014-01-13 09,4,4,0,0,0,0,0
2014-01-13 12,12,12,0,0,0,0,0
2014-01-13 13,4,4,0,0,0,0,0
2014-01-13 16,10,8,0,2,0,0,0
2014-01-13 17,2,1,0,1,0,0,0
2014-01-13 18,12,7,0,5,0,0,0
2014-01-13 19,1,0,0,1,0,0,0
2014-01-13 20,23,20,0,3,0,0,0
2014-01-13 21,13,13,0,0,0,0,0
2014-01-13 23,5,5,0,0,0,0,0
2014-01-14 07,3,2,0,1,0,0,0
2014-01-14 08,5,3,0,2,0,0,0
2014-01-14 10,43,9,0,34,0,0,0
2014-01-14 11,28,14,0,14,0,0,0
2014-01-14 12,25,8,0,17,0,0,0
2014-01-14 13,9,8,0,1,0,0,0
2014-01-14 15,15,13,0,2,0,0,0
2014-01-14 16,42,22,0,20,0,0,0
2014-01-14 17,27,12,0,15,0,0,0
2014-01-14 18,5,5,0,0,0,0,0
2014-01-14 19,26,9,0,17,0,0,0
2014-01-14 20,20,5,0,15,0,0,0
2014-01-14 21,3,0,0,3,0,0,0
2014-01-14 22,36,21,0,15,0,0,0
2014-01-14 23,4,3,0,1,0,0,0
2014-01-15 00,8,8,0,0,0,0,0
2014-01-15 08,1,1,0,0,0,0,0
2014-01-15 09,10,9,0,1,0,0,0
2014-01-15 10,4,1,0,3,0,0,0
2014-01-15 11,7,4,0,3,0,0,0
2014-01-15 12,3,2,0,1,0,0,0
2014-01-15 13,4,3,0,1,0,0,0
2014-01-15 14,16,13,0,3,0,0,0
2014-01-15 15,4,1,0,3,0,0,0
2014-01-15 16,26,11,0,15,0,0,0
2014-01-15 17,50,42,0,8,0,0,0
2014-01-15 18,2,0,0,2,0,0,0
2014-01-15 20,33,14,0,19,0,0,0
2014-01-15 21,1,0,0,1,0,0,0
2014-01-15 22,17,16,0,1,0,0,0
2014-01-15 23,1,0,0,1,0,0,0
2014-01-16 01,22,7,0,15,0,0,0
2014-01-16 02,12,1,0,11,0,0,0
2014-01-16 08,2,1,0,1,0,0,0
2014-01-16 09,24,20,0,4,0,0,0
2014-01-16 10,1,0,0,1,0,0,0
2014-01-16 11,9,4,0,5,0,0,0
2014-01-16 12,22,11,0,11,0,0,0
2014-01-16 13,32,11,0,21,0,0,0
2014-01-16 14,45,11,0,34,0,0,0
2014-01-16 15,14,8,0,6,0,0,0
2014-01-16 16,14,10,0,4,0,0,0
2014-01-16 17,13,6,0,7,0,0,0
2014-01-16 19,3,2,0,1,0,0,0
2014-01-16 20,19,9,0,10,0,0,0
2014-01-16 21,1,0,0,1,0,0,0
2014-01-16 22,40,25,0,15,0,0,0
2014-01-16 23,17,16,0,1,0,0,0
2014-01-17 00,10,9,0,1,0,0,0
2014-01-17 01,1,0,0,1,0,0,0
2014-01-17 07,1,1,0,0,0,0,0
2014-01-17 08,20,10,0,10,0,0,0
2014-01-17 09,17,8,0,9,0,0,0
2014-01-17 10,52,34,0,18,0,0,0
2014-01-17 11,4,0,0,4,0,0,0
2014-01-17 12,9,3,0,6,0,0,0
2014-01-17 13,25,18,0,7,0,0,0
2014-01-17 14,8,8,0,0,0,0,0
2014-01-17 15,30,11,0,19,0,0,0
2014-01-17 16,16,5,0,11,0,0,0
2014-01-17 17,16,16,0,0,0,0,0
2014-01-17 19,8,4,0,4,0,0,0
2014-01-17 21,8,8,0,0,0,0,0
2014-01-17 22,35,25,0,10,0,0,0
2014-01-17 23,2,0,0,2,0,0,0
2014-01-18 02,14,2,0,12,0,0,0
2014-01-18 08,2,0,0,2,0,0,0
2014-01-18 09,1,1,0,0,0,0,0
2014-01-18 12,14,12,0,2,0,0,0
2014-01-18 13,1,0,0,1,0,0,0
2014-01-18 14,2,0,0,2,0,0,0
2014-01-18 15,11,3,0,8,0,0,0
2014-01-18 16,7,5,0,2,0,0,0
2014-01-18 17,1,0,0,1,0,0,0
2014-01-18 19,2,0,0,2,0,0,0
2014-01-18 20,1,0,0,1,0,0,0
2014-01-18 21,1,0,0,1,0,0,0
2014-01-18 22,34,10,0,24,0,0,0
2014-01-18 23,3,1,0,2,0,0,0
2014-01-19 00,1,0,0,1,0,0,0
2014-01-19 01,2,1,0,1,0,0,0
2014-01-19 02,4,4,0,0,0,0,0
2014-01-19 09,16,16,0,0,0,0,0
2014-01-19 10,4,4,0,0,0,0,0
2014-01-19 11,1,1,0,0,0,0,0
2014-01-19 13,1,0,0,1,0,0,0
2014-01-19 14,16,5,0,11,0,0,0
2014-01-19 15,20,20,0,0,0,0,0
2014-01-19 16,15,5,0,10,0,0,0
2014-01-19 17,1,0,0,1,0,0,0
2014-01-19 20,1,0,0,1,0,0,0
2014-01-19 21,17,4,0,13,0,0,0
2014-01-19 22,3,1,0,2,0,0,0
2014-01-20 00,1,0,0,1,0,0,0
2014-01-20 09,20,20,0,0,0,0,0
2014-01-20 10,27,23,0,4,0,0,0
2014-01-20 11,19,17,0,2,0,0,0
2014-01-20 12,8,8,0,0,0,0,0
2014-01-20 14,47,18,0,29,0,0,0
2014-01-20 15,5,2,0,3,0,0,0
2014-01-20 16,14,13,0,1,0,0,0
2014-01-20 19,8,8,0,0,0,0,0
2014-01-20 21,9,8,0,1,0,0,0
2014-01-20 22,1,1,0,0,0,0,0
2014-01-20 23,8,8,0,0,0,0,0
2014-01-21 00,8,8,0,0,0,0,0
2014-01-21 01,1,0,0,1,0,0,0
2014-01-21 09,3,0,0,3,0,0,0
2014-01-21 10,2,0,0,2,0,0,0
2014-01-21 11,5,1,0,4,0,0,0
2014-01-21 12,2,0,0,2,0,0,0
2014-01-21 13,18,12,0,6,0,0,0
2014-01-21 14,16,16,0,0,0,0,0
2014-01-21 15,12,0,0,12,0,0,0
2014-01-21 16,8,7,0,1,0,0,0
2014-01-21 17,2,0,0,2,0,0,0
2014-01-21 18,15,12,0,3,0,0,0
2014-01-21 19,6,2,0,4,0,0,0
2014-01-21 20,5,3,0,2,0,0,0
2014-01-21 21,1,0,0,1,0,0,0
2014-01-21 22,9,9,0,0,0,0,0
2014-01-21 23,25,24,0,1,0,0,0
2014-01-22 00,1,1,0,0,0,0,0
2014-01-22 08,17,9,0,8,0,0,0
2014-01-22 09,6,4,0,2,0,0,0
2014-01-22 10,16,10,0,6,0,0,0
2014-01-22 11,13,13,0,0,0,0,0
2014-01-22 12,4,1,0,3,0,0,0
2014-01-22 13,34,20,0,14,0,0,0
2014-01-22 14,4,4,0,0,0,0,0
2014-01-22 15,21,16,0,5,0,0,0
2014-01-22 16,8,8,0,0,0,0,0
2014-01-22 19,17,6,0,11,0,0,0
2014-01-22 20,15,12,0,3,0,0,0
2014-01-22 21,12,12,0,0,0,0,0
2014-01-22 22,1,0,0,1,0,0,0
2014-01-22 23,1,0,0,1,0,0,0
2014-01-23 00,1,0,0,1,0,0,0
2014-01-23 03,1,0,0,1,0,0,0
2014-01-23 06,1,0,0,1,0,0,0
2014-01-23 07,1,0,0,1,0,0,0
2014-01-23 08,5,4,0,1,0,0,0
2014-01-23 09,12,4,0,8,0,0,0
2014-01-23 10,19,9,0,10,0,0,0
2014-01-23 11,1,0,0,1,0,0,0
2014-01-23 13,22,6,0,16,0,0,0
2014-01-23 14,12,12,0,0,0,0,0
2014-01-23 15,5,4,0,1,0,0,0
2014-01-23 16,4,4,0,0,0,0,0
2014-01-23 17,9,3,0,6,0,0,0
2014-01-23 19,1,0,0,1,0,0,0
2014-01-23 21,1,0,0,1,0,0,0
2014-01-24 00,13,6,0,7,0,0,0
2014-01-24 03,1,0,0,1,0,0,0
2014-01-24 04,1,0,0,1,0,0,0
2014-01-24 05,1,0,0,1,0,0,0
2014-01-24 08,12,12,0,0,0,0,0
2014-01-24 09,14,12,0,2,0,0,0
2014-01-24 10,18,5,0,13,0,0,0
2014-01-24 11,28,4,0,24,0,0,0
2014-01-24 14,16,16,0,0,0,0,0
2014-01-24 15,15,11,0,4,0,0,0
2014-01-24 16,10,6,0,4,0,0,0
2014-01-24 18,4,4,0,0,0,0,0
2014-01-24 20,1,0,0,1,0,0,0
2014-01-24 21,1,0,0,1,0,0,0
2014-01-24 23,15,9,0,6,0,0,0
2014-01-25 00,12,12,0,0,0,0,0
2014-01-25 02,1,0,0,1,0,0,0
2014-01-25 08,1,0,0,1,0,0,0
2014-01-25 09,1,0,0,1,0,0,0
2014-01-25 10,21,5,0,16,0,0,0
2014-01-25 13,6,3,0,3,0,0,0
2014-01-25 14,26,25,0,1,0,0,0
2014-01-25 17,1,1,0,0,0,0,0
2014-01-25 18,1,0,0,1,0,0,0
2014-01-25 19,1,0,0,1,0,0,0
2014-01-25 20,9,8,0,1,0,0,0
2014-01-25 21,3,1,0,2,0,0,0
2014-01-25 23,8,8,0,0,0,0,0
2014-01-26 00,1,0,0,1,0,0,0
2014-01-26 01,4,4,0,0,0,0,0
2014-01-26 06,1,0,0,1,0,0,0
2014-01-26 07,1,0,0,1,0,0,0
2014-01-26 08,1,0,0,1,0,0,0
2014-01-26 09,17,16,0,1,0,0,0
2014-01-26 12,20,20,0,0,0,0,0
2014-01-26 13,1,0,0,1,0,0,0
2014-01-26 14,4,4,0,0,0,0,0
2014-01-26 15,2,1,0,1,0,0,0
2014-01-26 16,17,5,0,12,0,0,0
2014-01-26 17,4,4,0,0,0,0,0
2014-01-26 18,5,5,0,0,0,0,0
2014-01-26 19,13,12,0,1,0,0,0
2014-01-26 20,1,1,0,0,0,0,0
2014-01-26 21,1,0,0,1,0,0,0
2014-01-26 22,46,40,0,6,0,0,0
2014-01-26 23,1,0,0,1,0,0,0
2014-01-27 01,1,0,0,1,0,0,0
2014-01-27 05,1,1,0,0,0,0,0
2014-01-27 07,1,0,0,1,0,0,0
2014-01-27 08,1,1,0,0,0,0,0
2014-01-27 09,1,0,0,1,0,0,0
2014-01-27 10,14,12,0,2,0,0,0
2014-01-27 11,9,8,0,1,0,0,0
2014-01-27 12,1,0,0,1,0,0,0
2014-01-27 13,33,33,0,0,0,0,0
2014-01-27 16,6,4,0,2,0,0,0
2014-01-27 17,12,12,0,0,0,0,0
2014-01-27 18,2,1,0,1,0,0,0
2014-01-27 20,22,9,0,13,0,0,0
2014-01-27 21,7,4,0,3,0,0,0
2014-01-27 22,13,12,0,1,0,0,0
2014-01-27 23,24,11,0,13,0,0,0
2014-01-28 00,10,7,0,3,0,0,0
2014-01-28 01,2,1,0,1,0,0,0
2014-01-28 02,1,0,0,1,0,0,0
2014-01-28 06,1,0,0,1,0,0,0
2014-01-28 08,1,0,0,1,0,0,0
2014-01-28 10,15,4,0,11,0,0,0
2014-01-28 12,9,8,0,1,0,0,0
2014-01-28 13,1,0,0,1,0,0,0
2014-01-28 15,19,14,0,5,0,0,0
2014-01-28 16,8,8,0,0,0,0,0
2014-01-28 19,8,8,0,0,0,0,0
2014-01-28 21,19,17,0,2,0,0,0
2014-01-28 22,1,0,0,1,0,0,0
2014-01-28 23,12,2,0,10,0,0,0
2014-01-29 00,8,8,0,0,0,0,0
2014-01-29 01,1,0,0,1,0,0,0
2014-01-29 02,1,0,0,1,0,0,0
2014-01-29 03,1,0,0,1,0,0,0
2014-01-29 06,9,8,0,1,0,0,0
2014-01-29 09,13,12,0,1,0,0,0
2014-01-29 11,1,0,0,1,0,0,0
2014-01-29 12,16,16,0,0,0,0,0
2014-01-29 13,25,25,0,0,0,0,0
2014-01-29 14,8,8,0,0,0,0,0
2014-01-29 16,4,4,0,0,0,0,0
2014-01-29 17,4,4,0,0,0,0,0
2014-01-29 18,8,8,0,0,0,0,0
2014-01-29 20,1,0,0,1,0,0,0
2014-01-29 21,24,24,0,0,0,0,0
2014-01-29 22,4,4,0,0,0,0,0
2014-01-29 23,4,0,0,4,0,0,0
2014-01-30 01,4,4,0,0,0,0,0
2014-01-30 09,2,0,0,2,0,0,0
2014-01-30 12,12,12,0,0,0,0,0
2014-01-30 14,24,24,0,0,0,0,0
2014-01-30 15,4,2,0,2,0,0,0
2014-01-30 17,4,4,0,0,0,0,0
2014-01-31 01,1,0,0,1,0,0,0
2014-01-31 03,1,0,0,1,0,0,0
2014-01-31 09,16,16,0,0,0,0,0
2014-01-31 10,9,8,0,1,0,0,0
2014-01-31 11,9,8,0,1,0,0,0
2014-01-31 14,20,20,0,0,0,0,0
2014-01-31 17,1,0,0,1,0,0,0
2014-01-31 18,6,5,0,1,0,0,0
2014-01-31 19,3,1,0,2,0,0,0
2014-01-31 21,23,5,0,18,0,0,0
2014-01-31 22,1,0,0,1,0,0,0
2014-01-31 23,1,0,0,1,0,0,0
2014-02-01 09,28,28,0,0,0,0,0
2014-02-01 11,6,5,0,1,0,0,0
2014-02-01 14,20,20,0,0,0,0,0
2014-02-01 16,4,4,0,0,0,0,0
2014-02-01 21,3,1,0,2,0,0,0
2014-02-02 10,20,20,0,0,0,0,0
2014-02-02 12,5,4,0,1,0,0,0
2014-02-02 13,36,36,0,0,0,0,0
2014-02-02 14,8,8,0,0,0,0,0
2014-02-02 15,8,8,0,0,0,0,0
2014-02-03 08,4,4,0,0,0,0,0
2014-02-03 09,25,25,0,0,0,0,0
2014-02-03 10,21,1,0,20,0,0,0
2014-02-03 11,24,24,0,0,0,0,0
2014-02-03 13,24,24,0,0,0,0,0
2014-02-03 14,24,6,0,18,0,0,0
2014-02-03 17,1,0,0,1,0,0,0
2014-02-04 08,4,4,0,0,0,0,0
2014-02-04 09,12,12,0,0,0,0,0
2014-02-04 10,8,8,0,0,0,0,0
2014-02-04 11,12,12,0,0,0,0,0
2014-02-11 09,11,1,0,10,0,0,0
2014-02-11 10,1,0,0,1,0,0,0
2014-02-11 11,1,1,0,0,0,0,0
2014-02-11 13,2,1,0,1,0,0,0
2014-02-11 14,1,1,0,0,0,0,0
2014-02-11 15,5,4,0,1,0,0,0
2014-02-11 18,10,9,0,1,0,0,0
2014-02-11 19,21,6,0,15,0,0,0
2014-02-11 20,2,0,0,2,0,0,0
2014-02-11 22,23,7,0,16,0,0,0
2014-02-12 00,16,7,0,9,0,0,0
2014-02-12 03,4,4,0,0,0,0,0
2014-02-12 09,30,10,0,20,0,0,0
2014-02-12 10,2,1,0,1,0,0,0
2014-02-12 11,1,0,0,1,0,0,0
2014-02-12 13,7,3,0,4,0,0,0
2014-02-12 14,2,1,0,1,0,0,0
2014-02-12 15,8,6,0,2,0,0,0
2014-02-12 16,8,8,0,0,0,0,0
2014-02-12 17,4,1,0,3,0,0,0
2014-02-12 18,4,4,0,0,0,0,0
2014-02-12 19,1,0,0,1,0,0,0
2014-02-12 20,1,1,0,0,0,0,0
2014-02-12 22,1,1,0,0,0,0,0
2014-02-12 23,1,0,0,1,0,0,0
2014-02-13 00,1,1,0,0,0,0,0
2014-02-13 09,21,8,0,13,0,0,0
2014-02-13 10,2,0,0,2,0,0,0
2014-02-13 11,6,4,0,2,0,0,0
2014-02-13 12,1,0,0,1,0,0,0
2014-02-13 19,16,3,0,13,0,0,0
2014-02-13 20,4,1,0,3,0,0,0
2014-02-13 21,1,0,0,1,0,0,0
2014-02-13 22,5,5,0,0,0,0,0
2014-02-14 00,5,1,0,4,0,0,0
2014-02-14 09,3,0,0,3,0,0,0
2014-02-14 10,1,1,0,0,0,0,0
2014-02-14 11,10,4,0,6,0,0,0
2014-02-14 12,5,4,0,1,0,0,0
2014-02-14 13,1,0,0,1,0,0,0
2014-02-14 16,4,4,0,0,0,0,0
2014-02-14 17,1,0,0,1,0,0,0
2014-02-14 22,1,0,0,1,0,0,0
2014-02-14 23,10,8,0,2,0,0,0
2014-02-15 00,6,4,0,2,0,0,0
2014-02-15 10,19,10,0,9,0,0,0
2014-02-15 11,4,4,0,0,0,0,0
2014-02-15 13,6,0,0,6,0,0,0
2014-02-15 14,3,1,0,2,0,0,0
2014-02-15 15,10,4,0,6,0,0,0
2014-02-15 16,5,4,0,1,0,0,0
2014-02-15 17,1,0,0,1,0,0,0
2014-02-15 19,1,0,0,1,0,0,0
2014-02-15 21,74,31,0,43,0,0,0
2014-02-15 22,1,0,0,1,0,0,0
2014-02-15 23,1,0,0,1,0,0,0
2014-02-16 00,4,2,0,2,0,0,0
2014-02-16 01,4,4,0,0,0,0,0
2014-02-16 02,21,4,0,17,0,0,0
2014-02-16 09,4,2,0,2,0,0,0
2014-02-16 11,8,8,0,0,0,0,0
2014-02-16 12,4,1,0,3,0,0,0
2014-02-16 13,11,5,0,6,0,0,0
2014-02-16 15,2,1,0,1,0,0,0
2014-02-16 17,13,6,0,7,0,0,0
2014-02-16 18,32,15,0,17,0,0,0
2014-02-16 20,2,1,0,1,0,0,0
2014-02-16 21,14,10,0,4,0,0,0
2014-02-16 22,43,18,0,25,0,0,0
2014-02-16 23,20,5,0,15,0,0,0
2014-02-17 07,8,8,0,0,0,0,0
2014-02-17 08,1,0,0,1,0,0,0
2014-02-17 09,4,4,0,0,0,0,0
2014-02-17 10,26,15,0,11,0,0,0
2014-02-17 11,5,5,0,0,0,0,0
2014-02-17 12,5,4,0,1,0,0,0
2014-02-17 13,6,5,0,1,0,0,0
2014-02-17 14,1,0,0,1,0,0,0
2014-02-17 15,2,0,0,2,0,0,0
2014-02-17 16,6,2,0,4,0,0,0
2014-02-17 18,2,1,0,1,0,0,0
2014-02-17 19,25,7,0,18,0,0,0
2014-02-17 20,16,16,0,0,0,0,0
2014-02-17 21,4,0,0,4,0,0,0
2014-02-17 22,30,15,0,15,0,0,0
2014-02-17 23,9,9,0,0,0,0,0
2014-02-18 00,21,7,0,14,0,0,0
2014-02-18 06,4,4,0,0,0,0,0
2014-02-18 10,33,10,0,23,0,0,0
2014-02-18 11,15,14,0,1,0,0,0
2014-02-18 12,2,0,0,2,0,0,0
2014-02-18 13,11,4,0,7,0,0,0
2014-02-18 14,17,16,0,1,0,0,0
2014-02-18 15,2,0,0,2,0,0,0
2014-02-18 16,9,8,0,1,0,0,0
2014-02-18 17,2,0,0,2,0,0,0
2014-02-18 18,18,5,0,13,0,0,0
2014-02-18 19,22,16,0,6,0,0,0
2014-02-18 20,16,2,0,14,0,0,0
2014-02-18 21,10,3,0,7,0,0,0
2014-02-18 22,1,1,0,0,0,0,0
2014-02-18 23,22,4,0,18,0,0,0
2014-02-19 00,2,0,0,2,0,0,0
2014-02-19 08,17,17,0,0,0,0,0
2014-02-19 09,18,7,0,11,0,0,0
2014-02-19 10,10,5,0,5,0,0,0
2014-02-19 11,40,6,0,34,0,0,0
2014-02-19 12,1,1,0,0,0,0,0
2014-02-19 13,1,1,0,0,0,0,0
2014-02-19 14,1,1,0,0,0,0,0
2014-02-19 15,21,5,0,16,0,0,0
2014-02-19 16,5,2,0,3,0,0,0
2014-02-19 17,10,8,0,2,0,0,0
2014-02-19 18,13,5,0,8,0,0,0
2014-02-19 19,2,0,0,2,0,0,0
2014-02-19 20,3,2,0,1,0,0,0
2014-02-19 21,2,0,0,2,0,0,0
2014-02-19 22,1,0,0,1,0,0,0
2014-02-20 00,12,12,0,0,0,0,0
2014-02-20 02,46,11,0,35,0,0,0
2014-02-20 05,1,0,0,1,0,0,0
2014-02-20 07,4,4,0,0,0,0,0
2014-02-20 08,1,1,0,0,0,0,0
2014-02-20 09,2,0,0,2,0,0,0
2014-02-20 10,9,4,0,5,0,0,0
2014-02-20 11,24,20,0,4,0,0,0
2014-02-20 12,17,12,0,5,0,0,0
2014-02-20 13,13,6,0,7,0,0,0
2014-02-20 14,5,0,0,5,0,0,0
2014-02-20 15,16,16,0,0,0,0,0
2014-02-20 16,2,2,0,0,0,0,0
2014-02-20 17,17,5,0,12,0,0,0
2014-02-20 18,4,0,0,4,0,0,0
2014-02-20 19,11,7,0,4,0,0,0
2014-02-20 20,29,24,0,5,0,0,0
2014-02-20 21,19,17,0,2,0,0,0
2014-02-20 22,19,9,0,10,0,0,0
2014-02-20 23,4,4,0,0,0,0,0
2014-02-21 06,8,8,0,0,0,0,0
2014-02-21 07,8,8,0,0,0,0,0
2014-02-21 08,9,9,0,0,0,0,0
2014-02-21 10,12,3,0,9,0,0,0
2014-02-21 11,4,4,0,0,0,0,0
2014-02-21 13,25,13,0,12,0,0,0
2014-02-21 14,12,5,0,7,0,0,0
2014-02-21 15,9,2,0,7,0,0,0
2014-02-21 17,2,1,0,1,0,0,0
2014-02-21 18,16,16,0,0,0,0,0
2014-02-21 19,5,0,0,5,0,0,0
2014-02-21 21,1,1,0,0,0,0,0
2014-02-21 22,12,12,0,0,0,0,0
2014-02-21 23,2,1,0,1,0,0,0
2014-02-22 00,1,0,0,1,0,0,0
2014-02-22 04,4,4,0,0,0,0,0
2014-02-22 08,8,1,0,7,0,0,0
2014-02-22 09,46,29,0,17,0,0,0
2014-02-22 10,24,4,0,20,0,0,0
2014-02-22 11,24,7,0,17,0,0,0
2014-02-22 12,4,4,0,0,0,0,0
2014-02-22 13,1,0,0,1,0,0,0
2014-02-22 14,28,24,0,4,0,0,0
2014-02-22 16,12,10,0,2,0,0,0
2014-02-22 17,12,12,0,0,0,0,0
2014-02-22 19,2,1,0,1,0,0,0
2014-02-22 22,11,4,0,7,0,0,0
2014-02-22 23,12,12,0,0,0,0,0
2014-02-23 03,4,4,0,0,0,0,0
2014-02-23 07,1,0,0,1,0,0,0
2014-02-23 08,20,10,0,10,0,0,0
2014-02-23 10,25,10,0,15,0,0,0
2014-02-23 12,9,5,0,4,0,0,0
2014-02-23 13,15,3,0,12,0,0,0
2014-02-23 14,13,8,0,5,0,0,0
2014-02-23 15,29,15,0,14,0,0,0
2014-02-23 16,9,4,0,5,0,0,0
2014-02-23 17,7,4,0,3,0,0,0
2014-02-23 18,10,4,0,6,0,0,0
2014-02-23 19,2,0,0,2,0,0,0
2014-02-23 21,2,1,0,1,0,0,0
2014-02-23 22,1,0,0,1,0,0,0
2014-02-23 23,1,0,0,1,0,0,0
2014-02-24 08,5,3,0,2,0,0,0
2014-02-24 09,5,3,0,2,0,0,0
2014-02-24 10,2,0,0,2,0,0,0
2014-02-24 11,22,22,0,0,0,0,0
2014-02-24 12,7,1,0,6,0,0,0
2014-02-24 13,40,40,0,0,0,0,0
2014-02-24 14,12,12,0,0,0,0,0
2014-02-24 15,1,0,0,1,0,0,0
2014-02-24 16,2,1,0,1,0,0,0
2014-02-24 17,9,2,0,7,0,0,0
2014-02-24 18,1,0,0,1,0,0,0
2014-02-24 19,29,28,0,1,0,0,0
2014-02-24 20,4,4,0,0,0,0,0
2014-02-24 21,6,4,0,2,0,0,0
2014-02-25 08,13,7,0,6,0,0,0
2014-02-25 09,9,2,0,7,0,0,0
2014-02-25 10,12,6,0,6,0,0,0
2014-02-25 11,18,16,0,2,0,0,0
2014-02-25 12,1,0,0,1,0,0,0
2014-02-25 13,9,8,0,1,0,0,0
2014-02-25 14,4,2,0,2,0,0,0
2014-02-25 15,7,4,0,3,0,0,0
2014-02-25 16,5,4,0,1,0,0,0
2014-02-25 18,16,16,0,0,0,0,0
2014-02-25 19,1,0,0,1,0,0,0
2014-02-25 20,5,0,0,5,0,0,0
2014-02-25 22,4,4,0,0,0,0,0
2014-02-25 23,4,4,0,0,0,0,0
2014-02-26 00,8,8,0,0,0,0,0
2014-02-26 05,8,8,0,0,0,0,0
2014-02-26 08,4,4,0,0,0,0,0
2014-02-26 13,8,8,0,0,0,0,0
2014-02-26 14,4,4,0,0,0,0,0
2014-02-26 17,12,12,0,0,0,0,0
2014-02-26 18,12,12,0,0,0,0,0
2014-02-26 21,12,12,0,0,0,0,0
2014-02-27 01,4,4,0,0,0,0,0
2014-02-27 09,1,1,0,0,0,0,0
2014-02-27 10,12,12,0,0,0,0,0
2014-02-27 12,4,4,0,0,0,0,0
2014-02-27 13,12,12,0,0,0,0,0
2014-02-27 15,1,1,0,0,0,0,0
2014-02-27 17,5,4,0,1,0,0,0
2014-02-27 19,1,0,0,1,0,0,0
2014-02-27 21,12,12,0,0,0,0,0
2014-02-27 23,2,0,0,2,0,0,0
2014-02-28 03,1,0,0,1,0,0,0
2014-02-28 06,5,4,0,1,0,0,0
2014-02-28 07,8,8,0,0,0,0,0
2014-02-28 08,17,17,0,0,0,0,0
2014-02-28 09,5,5,0,0,0,0,0
2014-02-28 10,1,1,0,0,0,0,0
2014-02-28 12,8,8,0,0,0,0,0
2014-02-28 13,2,0,0,2,0,0,0
2014-02-28 15,9,8,0,1,0,0,0
2014-02-28 17,9,8,0,1,0,0,0
2014-02-28 20,30,28,0,2,0,0,0
2014-02-28 21,4,4,0,0,0,0,0
2014-02-28 22,8,8,0,0,0,0,0
2014-03-01 00,5,4,0,1,0,0,0
2014-03-01 02,1,0,0,1,0,0,0
2014-03-01 03,1,0,0,1,0,0,0
2014-03-01 05,1,0,0,1,0,0,0
2014-03-01 06,1,0,0,1,0,0,0
2014-03-01 07,8,8,0,0,0,0,0
2014-03-01 10,13,12,0,1,0,0,0
2014-03-01 11,16,16,0,0,0,0,0
2014-03-01 12,5,4,0,1,0,0,0
2014-03-01 13,2,0,0,2,0,0,0
2014-03-01 17,8,3,0,5,0,0,0
2014-03-01 18,8,8,0,0,0,0,0
2014-03-01 20,1,0,0,1,0,0,0
2014-03-01 21,2,0,0,2,0,0,0
2014-03-02 01,1,0,0,1,0,0,0
2014-03-02 03,1,0,0,1,0,0,0
2014-03-02 06,1,0,0,1,0,0,0
2014-03-02 07,4,4,0,0,0,0,0
2014-03-02 10,1,0,0,1,0,0,0
2014-03-02 11,21,20,0,1,0,0,0
2014-03-02 13,1,0,0,1,0,0,0
2014-03-02 14,8,8,0,0,0,0,0
2014-03-02 15,5,4,0,1,0,0,0
2014-03-02 16,1,0,0,1,0,0,0
2014-03-02 17,5,4,0,1,0,0,0
2014-03-02 18,13,12,0,1,0,0,0
2014-03-02 19,1,0,0,1,0,0,0
2014-03-02 21,2,0,0,2,0,0,0
2014-03-02 22,1,0,0,1,0,0,0
2014-03-02 23,1,0,0,1,0,0,0
2014-03-03 00,4,4,0,0,0,0,0
2014-03-03 05,1,0,0,1,0,0,0
2014-03-03 08,1,1,0,0,0,0,0
2014-03-03 09,6,4,0,2,0,0,0
2014-03-03 10,1,1,0,0,0,0,0
2014-03-03 11,1,0,0,1,0,0,0
2014-03-03 12,5,4,0,1,0,0,0
2014-03-03 13,1,0,0,1,0,0,0
2014-03-03 14,2,0,0,2,0,0,0
2014-03-03 15,4,4,0,0,0,0,0
2014-03-03 16,8,4,0,4,0,0,0
2014-03-03 17,19,16,0,3,0,0,0
2014-03-03 18,1,0,0,1,0,0,0
2014-03-03 19,16,16,0,0,0,0,0
2014-03-03 20,1,0,0,1,0,0,0
2014-03-03 21,1,0,0,1,0,0,0
2014-03-03 23,16,16,0,0,0,0,0
2014-03-04 08,14,6,0,8,0,0,0
2014-03-04 09,1,0,0,1,0,0,0
2014-03-04 10,10,6,0,4,0,0,0
2014-03-04 11,4,2,0,2,0,0,0
2014-03-04 12,1,0,0,1,0,0,0
2014-03-04 13,2,0,0,2,0,0,0
2014-03-04 14,1,0,0,1,0,0,0
2014-03-04 15,12,12,0,0,0,0,0
2014-03-04 18,4,4,0,0,0,0,0
2014-03-05 00,1,0,0,1,0,0,0
2014-03-05 08,1,0,0,1,0,0,0
2014-03-05 10,3,2,0,1,0,0,0
2014-03-05 11,4,4,0,0,0,0,0
2014-03-05 12,4,4,0,0,0,0,0
2014-03-05 13,4,4,0,0,0,0,0
2014-03-05 15,5,4,0,1,0,0,0
2014-03-05 17,2,0,0,2,0,0,0
2014-03-05 18,8,8,0,0,0,0,0
2014-03-05 23,2,1,0,1,0,0,0
2014-03-06 00,12,12,0,0,0,0,0
2014-03-06 01,1,0,0,1,0,0,0
2014-03-06 02,1,0,0,1,0,0,0
2014-03-06 05,1,0,0,1,0,0,0
2014-03-06 07,1,0,0,1,0,0,0
2014-03-06 09,1,0,0,1,0,0,0
2014-03-06 12,1,0,0,1,0,0,0
2014-03-06 13,1,0,0,1,0,0,0
2014-03-06 16,20,20,0,0,0,0,0
2014-03-06 19,1,0,0,1,0,0,0
2014-03-06 20,4,4,0,0,0,0,0
2014-03-06 21,2,0,0,2,0,0,0
2014-03-06 22,5,4,0,1,0,0,0
2014-03-06 23,2,0,0,2,0,0,0
2014-03-07 00,3,0,0,3,0,0,0
