date,ALL,A,NS,CNAME,PTR,TXT,AAAA
2014-01-07 17,144,138,0,6,0,0,0
2014-01-07 18,134,127,0,7,0,0,0
2014-01-07 19,100,96,0,4,0,0,0
2014-01-07 20,147,140,0,7,0,0,0
2014-01-07 21,155,147,0,8,0,0,0
2014-01-07 22,123,119,0,4,0,0,0
2014-01-07 23,59,58,0,1,0,0,0
2014-01-08 00,30,30,0,0,0,0,0
2014-01-08 01,16,16,0,0,0,0,0
2014-01-08 02,8,8,0,0,0,0,0
2014-01-08 03,23,22,0,1,0,0,0
2014-01-08 04,6,6,0,0,0,0,0
2014-01-08 05,11,11,0,0,0,0,0
2014-01-08 06,12,10,0,2,0,0,0
2014-01-08 07,41,36,0,5,0,0,0
2014-01-08 08,34,31,0,3,0,0,0
2014-01-08 09,58,56,0,2,0,0,0
2014-01-08 10,138,133,0,5,0,0,0
2014-01-08 11,74,70,0,4,0,0,0
2014-01-08 12,104,95,0,9,0,0,0
2014-01-08 13,99,93,0,6,0,0,0
2014-01-08 14,43,41,0,2,0,0,0
2014-01-08 15,63,58,0,5,0,0,0
2014-01-08 16,119,112,0,7,0,0,0
2014-01-08 17,67,63,0,4,0,0,0
2014-01-08 18,50,47,0,3,0,0,0
2014-01-08 19,84,83,0,1,0,0,0
2014-01-08 20,94,88,0,6,0,0,0
2014-01-08 21,150,141,0,9,0,0,0
2014-01-08 22,126,123,0,3,0,0,0
2014-01-08 23,64,60,0,4,0,0,0
2014-01-09 00,13,13,0,0,0,0,0
2014-01-09 01,26,24,0,2,0,0,0
2014-01-09 02,15,13,0,2,0,0,0
2014-01-09 03,35,34,0,1,0,0,0
2014-01-09 04,19,18,0,1,0,0,0
2014-01-09 05,15,15,0,0,0,0,0
2014-01-09 06,3,3,0,0,0,0,0
2014-01-09 07,17,17,0,0,0,0,0
2014-01-09 08,22,21,0,1,0,0,0
2014-01-09 09,72,69,0,3,0,0,0
2014-01-09 10,145,139,0,6,0,0,0
2014-01-09 11,119,109,0,10,0,0,0
2014-01-09 12,100,93,0,7,0,0,0
2014-01-09 13,104,88,0,16,0,0,0
2014-01-09 14,116,109,0,7,0,0,0
2014-01-09 15,93,90,0,3,0,0,0
2014-01-09 16,77,73,0,4,0,0,0
2014-01-09 17,59,56,0,3,0,0,0
2014-01-09 18,57,56,0,1,0,0,0
2014-01-09 19,55,54,0,1,0,0,0
2014-01-09 20,72,67,0,5,0,0,0
2014-01-09 21,92,84,0,8,0,0,0
2014-01-09 22,89,88,0,1,0,0,0
2014-01-09 23,60,59,0,1,0,0,0
2014-01-10 00,27,26,0,1,0,0,0
2014-01-10 01,57,51,0,6,0,0,0
2014-01-10 02,64,58,0,6,0,0,0
2014-01-10 03,24,21,0,3,0,0,0
2014-01-10 04,31,29,0,2,0,0,0
2014-01-10 05,15,15,0,0,0,0,0
2014-01-10 06,13,12,0,1,0,0,0
2014-01-10 07,29,26,0,3,0,0,0
2014-01-10 08,45,42,0,3,0,0,0
2014-01-10 09,55,55,0,0,0,0,0
2014-01-10 10,70,68,0,2,0,0,0
2014-01-10 11,97,93,0,4,0,0,0
2014-01-10 12,100,92,0,8,0,0,0
2014-01-10 13,73,66,0,7,0,0,0
2014-01-10 14,122,114,0,8,0,0,0
2014-01-10 15,87,81,0,6,0,0,0
2014-01-10 16,97,89,0,8,0,0,0
2014-01-10 17,90,84,0,6,0,0,0
2014-01-10 18,60,59,0,1,0,0,0
2014-01-10 19,84,80,0,4,0,0,0
2014-01-10 20,51,50,0,1,0,0,0
2014-01-10 21,65,64,0,1,0,0,0
2014-01-10 22,52,50,0,2,0,0,0
2014-01-10 23,50,49,0,1,0,0,0
2014-01-11 00,41,39,0,2,0,0,0
2014-01-11 01,57,50,0,7,0,0,0
2014-01-11 02,33,29,0,4,0,0,0
2014-01-11 03,23,21,0,2,0,0,0
2014-01-11 04,30,26,0,4,0,0,0
2014-01-11 05,25,21,0,4,0,0,0
2014-01-11 06,15,13,0,2,0,0,0
2014-01-11 07,27,24,0,3,0,0,0
2014-01-11 08,23,20,0,3,0,0,0
2014-01-11 09,42,35,0,7,0,0,0
2014-01-11 10,67,65,0,2,0,0,0
2014-01-11 11,60,55,0,5,0,0,0
2014-01-11 12,41,41,0,0,0,0,0
2014-01-11 13,50,50,0,0,0,0,0
2014-01-11 14,91,82,0,9,0,0,0
2014-01-11 20,142,137,0,5,0,0,0
2014-01-11 21,53,53,0,0,0,0,0
2014-01-11 23,28,26,0,2,0,0,0
2014-01-12 00,6,5,0,1,0,0,0
2014-01-12 01,22,20,0,2,0,0,0
2014-01-12 02,20,18,0,2,0,0,0
2014-01-12 03,13,13,0,0,0,0,0
2014-01-12 04,6,6,0,0,0,0,0
2014-01-12 05,12,11,0,1,0,0,0
2014-01-12 06,12,10,0,2,0,0,0
2014-01-12 07,2,2,0,0,0,0,0
2014-01-12 08,2,2,0,0,0,0,0
2014-01-12 09,16,16,0,0,0,0,0
2014-01-12 10,26,25,0,1,0,0,0
2014-01-12 11,34,34,0,0,0,0,0
2014-01-12 12,28,25,0,3,0,0,0
2014-01-12 13,27,26,0,1,0,0,0
2014-01-12 14,25,24,0,1,0,0,0
2014-01-12 15,30,27,0,3,0,0,0
2014-01-12 16,31,29,0,2,0,0,0
2014-01-12 17,48,42,0,6,0,0,0
2014-01-12 18,18,16,0,2,0,0,0
2014-01-12 19,19,16,0,3,0,0,0
2014-01-12 20,34,34,0,0,0,0,0
2014-01-12 21,22,20,0,2,0,0,0
2014-01-12 22,126,121,0,5,0,0,0
2014-01-12 23,41,38,0,3,0,0,0
2014-01-13 00,26,25,0,1,0,0,0
2014-01-13 01,24,21,0,3,0,0,0
2014-01-13 02,52,49,0,3,0,0,0
2014-01-13 03,21,17,0,4,0,0,0
2014-01-13 04,12,9,0,3,0,0,0
2014-01-13 05,11,11,0,0,0,0,0
2014-01-13 06,1,1,0,0,0,0,0
2014-01-13 07,18,18,0,0,0,0,0
2014-01-13 08,43,42,0,1,0,0,0
2014-01-13 09,37,35,0,2,0,0,0
2014-01-13 10,38,36,0,2,0,0,0
2014-01-13 11,66,60,0,6,0,0,0
2014-01-13 12,55,51,0,4,0,0,0
2014-01-13 13,77,73,0,4,0,0,0
2014-01-13 14,26,26,0,0,0,0,0
2014-01-13 15,51,45,0,6,0,0,0
2014-01-13 16,126,123,0,3,0,0,0
2014-01-13 17,121,119,0,2,0,0,0
2014-01-13 18,83,79,0,4,0,0,0
2014-01-13 19,66,61,0,5,0,0,0
2014-01-13 20,96,93,0,3,0,0,0
2014-01-13 21,59,58,0,1,0,0,0
2014-01-13 22,64,63,0,1,0,0,0
2014-01-13 23,36,36,0,0,0,0,0
2014-01-14 00,39,35,0,4,0,0,0
2014-01-14 01,28,26,0,2,0,0,0
2014-01-14 02,30,27,0,3,0,0,0
2014-01-14 03,25,23,0,2,0,0,0
2014-01-14 04,35,31,0,4,0,0,0
2014-01-14 05,30,26,0,4,0,0,0
2014-01-14 06,5,5,0,0,0,0,0
2014-01-14 07,23,21,0,2,0,0,0
2014-01-14 08,19,19,0,0,0,0,0
2014-01-14 09,53,51,0,2,0,0,0
2014-01-14 10,141,132,0,9,0,0,0
2014-01-14 11,109,102,0,7,0,0,0
2014-01-14 12,129,121,0,8,0,0,0
2014-01-14 13,117,108,0,9,0,0,0
2014-01-14 14,106,97,0,9,0,0,0
2014-01-14 15,157,153,0,4,0,0,0
2014-01-14 16,187,181,0,6,0,0,0
2014-01-14 17,70,67,0,3,0,0,0
2014-01-14 18,139,133,0,6,0,0,0
2014-01-14 19,98,91,0,7,0,0,0
2014-01-14 20,74,68,0,6,0,0,0
2014-01-14 21,127,120,0,7,0,0,0
2014-01-14 22,72,69,0,3,0,0,0
2014-01-14 23,69,65,0,4,0,0,0
2014-01-15 00,33,31,0,2,0,0,0
2014-01-15 01,35,34,0,1,0,0,0
2014-01-15 02,13,11,0,2,0,0,0
2014-01-15 03,49,47,0,2,0,0,0
2014-01-15 04,15,15,0,0,0,0,0
2014-01-15 05,25,24,0,1,0,0,0
2014-01-15 06,10,9,0,1,0,0,0
2014-01-15 07,19,17,0,2,0,0,0
2014-01-15 08,38,37,0,1,0,0,0
2014-01-15 09,64,61,0,3,0,0,0
2014-01-15 10,71,64,0,7,0,0,0
2014-01-15 11,67,62,0,5,0,0,0
2014-01-15 12,86,77,0,9,0,0,0
2014-01-15 13,143,139,0,4,0,0,0
2014-01-15 14,132,126,0,6,0,0,0
2014-01-15 15,161,155,0,6,0,0,0
2014-01-15 16,90,88,0,2,0,0,0
2014-01-15 17,42,40,0,2,0,0,0
2014-01-15 18,38,36,0,2,0,0,0
2014-01-15 20,28,26,0,2,0,0,0
2014-01-15 21,94,89,0,5,0,0,0
2014-01-15 22,93,87,0,6,0,0,0
2014-01-15 23,28,26,0,2,0,0,0
2014-01-16 00,44,40,0,4,0,0,0
2014-01-16 01,39,34,0,5,0,0,0
2014-01-16 02,19,18,0,1,0,0,0
2014-01-16 03,29,27,0,2,0,0,0
2014-01-16 04,30,26,0,4,0,0,0
2014-01-16 05,4,4,0,0,0,0,0
2014-01-16 06,14,12,0,2,0,0,0
2014-01-16 07,23,22,0,1,0,0,0
2014-01-16 08,39,37,0,2,0,0,0
2014-01-16 09,74,70,0,4,0,0,0
2014-01-16 10,113,107,0,6,0,0,0
2014-01-16 11,91,88,0,3,0,0,0
2014-01-16 12,79,76,0,3,0,0,0
2014-01-16 13,114,112,0,2,0,0,0
2014-01-16 14,145,138,0,7,0,0,0
2014-01-16 15,128,125,0,3,0,0,0
2014-01-16 16,126,119,0,7,0,0,0
2014-01-16 17,59,57,0,2,0,0,0
2014-01-16 18,91,87,0,4,0,0,0
2014-01-16 19,151,147,0,4,0,0,0
2014-01-16 20,70,66,0,4,0,0,0
2014-01-16 21,64,59,0,5,0,0,0
2014-01-16 22,79,75,0,4,0,0,0
2014-01-16 23,50,46,0,4,0,0,0
2014-01-17 00,55,50,0,5,0,0,0
2014-01-17 01,55,45,0,10,0,0,0
2014-01-17 02,25,23,0,2,0,0,0
2014-01-17 03,10,10,0,0,0,0,0
2014-01-17 04,40,38,0,2,0,0,0
2014-01-17 05,15,14,0,1,0,0,0
2014-01-17 06,20,18,0,2,0,0,0
2014-01-17 07,38,31,0,7,0,0,0
2014-01-17 08,43,40,0,3,0,0,0
2014-01-17 09,63,58,0,5,0,0,0
2014-01-17 10,51,47,0,4,0,0,0
2014-01-17 11,82,78,0,4,0,0,0
2014-01-17 12,79,79,0,0,0,0,0
2014-01-17 13,110,105,0,5,0,0,0
2014-01-17 14,86,83,0,3,0,0,0
2014-01-17 15,99,97,0,2,0,0,0
2014-01-17 16,122,116,0,6,0,0,0
2014-01-17 17,104,99,0,5,0,0,0
2014-01-17 18,25,24,0,1,0,0,0
2014-01-17 19,13,12,0,1,0,0,0
2014-01-17 20,18,17,0,1,0,0,0
2014-01-17 21,18,17,0,1,0,0,0
2014-01-17 22,18,18,0,0,0,0,0
2014-01-17 23,11,11,0,0,0,0,0
2014-01-18 00,28,28,0,0,0,0,0
2014-01-18 01,5,4,0,1,0,0,0
2014-01-18 02,21,21,0,0,0,0,0
2014-01-18 03,4,3,0,1,0,0,0
2014-01-18 04,17,16,0,1,0,0,0
2014-01-18 05,9,8,0,1,0,0,0
2014-01-18 06,7,7,0,0,0,0,0
2014-01-18 07,21,20,0,1,0,0,0
2014-01-18 08,9,7,0,2,0,0,0
2014-01-18 09,17,17,0,0,0,0,0
2014-01-18 10,27,26,0,1,0,0,0
2014-01-18 11,15,14,0,1,0,0,0
2014-01-18 12,25,25,0,0,0,0,0
2014-01-18 13,73,68,0,5,0,0,0
2014-01-18 14,48,45,0,3,0,0,0
2014-01-18 15,57,56,0,1,0,0,0
2014-01-18 16,57,56,0,1,0,0,0
2014-01-18 17,59,56,0,3,0,0,0
2014-01-18 18,32,32,0,0,0,0,0
2014-01-18 19,36,34,0,2,0,0,0
2014-01-18 20,32,31,0,1,0,0,0
2014-01-18 21,47,46,0,1,0,0,0
2014-01-18 22,45,42,0,3,0,0,0
2014-01-18 23,49,47,0,2,0,0,0
2014-01-19 00,34,32,0,2,0,0,0
2014-01-19 01,21,20,0,1,0,0,0
2014-01-19 02,11,10,0,1,0,0,0
2014-01-19 03,11,11,0,0,0,0,0
2014-01-19 04,8,8,0,0,0,0,0
2014-01-19 05,4,3,0,1,0,0,0
2014-01-19 06,10,10,0,0,0,0,0
2014-01-19 07,14,14,0,0,0,0,0
2014-01-19 08,9,9,0,0,0,0,0
2014-01-19 09,13,13,0,0,0,0,0
2014-01-19 10,22,22,0,0,0,0,0
2014-01-19 11,11,11,0,0,0,0,0
2014-01-19 12,35,32,0,3,0,0,0
2014-01-19 13,53,51,0,2,0,0,0
2014-01-19 14,41,41,0,0,0,0,0
2014-01-19 15,100,93,0,7,0,0,0
2014-01-19 16,51,50,0,1,0,0,0
2014-01-19 17,40,40,0,0,0,0,0
2014-01-19 18,79,77,0,2,0,0,0
2014-01-19 19,40,39,0,1,0,0,0
2014-01-19 20,29,29,0,0,0,0,0
2014-01-19 21,63,61,0,2,0,0,0
2014-01-19 22,19,19,0,0,0,0,0
2014-01-19 23,9,9,0,0,0,0,0
2014-01-20 00,27,26,0,1,0,0,0
2014-01-20 01,31,29,0,2,0,0,0
2014-01-20 02,20,17,0,3,0,0,0
2014-01-20 03,12,12,0,0,0,0,0
2014-01-20 04,10,9,0,1,0,0,0
2014-01-20 05,10,9,0,1,0,0,0
2014-01-20 06,6,5,0,1,0,0,0
2014-01-20 07,3,3,0,0,0,0,0
2014-01-20 08,26,26,0,0,0,0,0
2014-01-20 09,36,33,0,3,0,0,0
2014-01-20 10,22,21,0,1,0,0,0
2014-01-20 11,44,43,0,1,0,0,0
2014-01-20 12,32,28,0,4,0,0,0
2014-01-20 13,96,92,0,4,0,0,0
2014-01-20 14,110,106,0,4,0,0,0
2014-01-20 15,83,78,0,5,0,0,0
2014-01-20 16,40,40,0,0,0,0,0
2014-01-20 17,85,82,0,3,0,0,0
2014-01-20 18,58,55,0,3,0,0,0
2014-01-20 19,40,39,0,1,0,0,0
2014-01-20 20,28,28,0,0,0,0,0
2014-01-20 21,22,22,0,0,0,0,0
2014-01-20 22,16,16,0,0,0,0,0
2014-01-20 23,32,31,0,1,0,0,0
2014-01-21 00,3,3,0,0,0,0,0
2014-01-21 01,4,3,0,1,0,0,0
2014-01-21 02,162,161,0,1,0,0,0
2014-01-21 03,11,11,0,0,0,0,0
2014-01-21 04,10,10,0,0,0,0,0
2014-01-21 05,7,6,0,1,0,0,0
2014-01-21 06,1,1,0,0,0,0,0
2014-01-21 07,3,3,0,0,0,0,0
2014-01-21 08,6,6,0,0,0,0,0
2014-01-21 09,15,14,0,1,0,0,0
2014-01-21 10,12,11,0,1,0,0,0
2014-01-21 11,22,20,0,2,0,0,0
2014-01-21 12,60,56,0,4,0,0,0
2014-01-21 13,88,81,0,7,0,0,0
2014-01-21 14,36,35,0,1,0,0,0
2014-01-21 15,31,29,0,2,0,0,0
2014-01-21 16,35,31,0,4,0,0,0
2014-01-21 17,31,30,0,1,0,0,0
2014-01-21 18,26,24,0,2,0,0,0
2014-01-21 19,33,29,0,4,0,0,0
2014-01-21 20,50,45,0,5,0,0,0
2014-01-21 21,33,31,0,2,0,0,0
2014-01-21 22,21,19,0,2,0,0,0
2014-01-21 23,56,54,0,2,0,0,0
2014-01-22 00,16,14,0,2,0,0,0
2014-01-22 01,18,15,0,3,0,0,0
2014-01-22 02,17,15,0,2,0,0,0
2014-01-22 03,8,7,0,1,0,0,0
2014-01-22 04,88,87,0,1,0,0,0
2014-01-22 05,12,11,0,1,0,0,0
2014-01-22 06,21,20,0,1,0,0,0
2014-01-22 07,9,9,0,0,0,0,0
2014-01-22 08,16,16,0,0,0,0,0
2014-01-22 09,50,47,0,3,0,0,0
2014-01-22 10,53,52,0,1,0,0,0
2014-01-22 11,49,46,0,3,0,0,0
2014-01-22 12,31,30,0,1,0,0,0
2014-01-22 13,29,28,0,1,0,0,0
2014-01-22 14,46,45,0,1,0,0,0
2014-01-22 15,141,139,0,2,0,0,0
2014-01-22 16,23,22,0,1,0,0,0
2014-01-22 17,21,21,0,0,0,0,0
2014-01-22 18,5,5,0,0,0,0,0
2014-01-22 19,10,9,0,1,0,0,0
2014-01-22 20,46,45,0,1,0,0,0
2014-01-22 21,60,58,0,2,0,0,0
2014-01-22 22,24,24,0,0,0,0,0
2014-01-22 23,15,15,0,0,0,0,0
2014-01-23 00,17,17,0,0,0,0,0
2014-01-23 01,11,11,0,0,0,0,0
2014-01-23 02,2,1,0,1,0,0,0
2014-01-23 03,13,11,0,2,0,0,0
2014-01-23 04,3,2,0,1,0,0,0
2014-01-23 05,3,3,0,0,0,0,0
2014-01-23 06,1,1,0,0,0,0,0
2014-01-23 07,2,2,0,0,0,0,0
2014-01-23 08,12,12,0,0,0,0,0
2014-01-23 09,4,4,0,0,0,0,0
2014-01-23 10,12,12,0,0,0,0,0
2014-01-23 11,16,16,0,0,0,0,0
2014-01-23 12,27,27,0,0,0,0,0
2014-01-23 13,32,31,0,1,0,0,0
2014-01-23 14,32,31,0,1,0,0,0
2014-01-23 15,77,74,0,3,0,0,0
2014-01-23 16,43,43,0,0,0,0,0
2014-01-23 17,22,22,0,0,0,0,0
2014-01-23 18,29,29,0,0,0,0,0
2014-01-23 19,18,17,0,1,0,0,0
2014-01-23 20,27,27,0,0,0,0,0
2014-01-23 21,20,20,0,0,0,0,0
2014-01-23 22,16,16,0,0,0,0,0
2014-01-23 23,14,13,0,1,0,0,0
2014-01-24 00,7,7,0,0,0,0,0
2014-01-24 01,23,20,0,3,0,0,0
2014-01-24 02,6,6,0,0,0,0,0
2014-01-24 03,6,6,0,0,0,0,0
2014-01-24 04,5,4,0,1,0,0,0
2014-01-24 05,10,10,0,0,0,0,0
2014-01-24 06,7,6,0,1,0,0,0
2014-01-24 07,13,12,0,1,0,0,0
2014-01-24 08,4,4,0,0,0,0,0
2014-01-24 09,15,15,0,0,0,0,0
2014-01-24 10,15,15,0,0,0,0,0
2014-01-24 11,30,30,0,0,0,0,0
2014-01-24 12,17,17,0,0,0,0,0
2014-01-24 13,25,25,0,0,0,0,0
2014-01-24 14,14,14,0,0,0,0,0
2014-01-24 15,26,25,0,1,0,0,0
2014-01-24 16,17,16,0,1,0,0,0
2014-01-24 17,23,23,0,0,0,0,0
2014-01-24 18,32,31,0,1,0,0,0
2014-01-24 19,39,38,0,1,0,0,0
2014-01-24 20,44,42,0,2,0,0,0
2014-01-24 21,24,23,0,1,0,0,0
2014-01-24 22,19,19,0,0,0,0,0
2014-01-24 23,20,19,0,1,0,0,0
2014-01-25 00,39,36,0,3,0,0,0
2014-01-25 01,19,19,0,0,0,0,0
2014-01-25 02,7,7,0,0,0,0,0
2014-01-25 03,1,1,0,0,0,0,0
2014-01-25 04,8,8,0,0,0,0,0
2014-01-25 05,3,3,0,0,0,0,0
2014-01-25 06,3,2,0,1,0,0,0
2014-01-25 07,13,13,0,0,0,0,0
2014-01-25 08,9,9,0,0,0,0,0
2014-01-25 09,39,38,0,1,0,0,0
2014-01-25 10,22,21,0,1,0,0,0
2014-01-25 11,32,32,0,0,0,0,0
2014-01-25 12,11,11,0,0,0,0,0
2014-01-25 13,8,8,0,0,0,0,0
2014-01-25 14,54,52,0,2,0,0,0
2014-01-25 15,15,15,0,0,0,0,0
2014-01-25 16,18,17,0,1,0,0,0
2014-01-25 17,15,13,0,2,0,0,0
2014-01-25 18,22,22,0,0,0,0,0
2014-01-25 19,2,2,0,0,0,0,0
2014-01-25 20,42,40,0,2,0,0,0
2014-01-25 21,4,4,0,0,0,0,0
2014-01-25 22,37,36,0,1,0,0,0
2014-01-25 23,23,22,0,1,0,0,0
2014-01-26 00,18,17,0,1,0,0,0
2014-01-26 01,9,7,0,2,0,0,0
2014-01-26 02,10,10,0,0,0,0,0
2014-01-26 03,6,6,0,0,0,0,0
2014-01-26 04,5,5,0,0,0,0,0
2014-01-26 05,4,4,0,0,0,0,0
2014-01-26 06,6,5,0,1,0,0,0
2014-01-26 07,17,17,0,0,0,0,0
2014-01-26 08,10,10,0,0,0,0,0
2014-01-26 09,14,13,0,1,0,0,0
2014-01-26 10,4,4,0,0,0,0,0
2014-01-26 11,20,19,0,1,0,0,0
2014-01-26 12,23,21,0,2,0,0,0
2014-01-26 13,29,27,0,2,0,0,0
2014-01-26 14,34,32,0,2,0,0,0
2014-01-26 15,14,13,0,1,0,0,0
2014-01-26 16,19,17,0,2,0,0,0
2014-01-26 17,29,28,0,1,0,0,0
2014-01-26 18,15,15,0,0,0,0,0
2014-01-26 19,13,11,0,2,0,0,0
2014-01-26 20,28,26,0,2,0,0,0
2014-01-26 21,81,79,0,2,0,0,0
2014-01-26 22,23,21,0,2,0,0,0
2014-01-26 23,16,15,0,1,0,0,0
2014-01-27 00,2,2,0,0,0,0,0
2014-01-27 01,1,1,0,0,0,0,0
2014-01-27 02,34,33,0,1,0,0,0
2014-01-27 03,8,8,0,0,0,0,0
2014-01-27 04,22,21,0,1,0,0,0
2014-01-27 05,7,6,0,1,0,0,0
2014-01-27 06,9,7,0,2,0,0,0
2014-01-27 07,10,9,0,1,0,0,0
2014-01-27 08,15,14,0,1,0,0,0
2014-01-27 09,25,24,0,1,0,0,0
2014-01-27 10,3,3,0,0,0,0,0
2014-01-27 11,5,4,0,1,0,0,0
2014-01-27 12,22,18,0,4,0,0,0
2014-01-27 13,13,11,0,2,0,0,0
2014-01-27 14,41,36,0,5,0,0,0
2014-01-27 15,40,39,0,1,0,0,0
2014-01-27 16,23,22,0,1,0,0,0
2014-01-27 17,32,26,0,6,0,0,0
2014-01-27 18,11,8,0,3,0,0,0
2014-01-27 19,9,7,0,2,0,0,0
2014-01-27 20,17,15,0,2,0,0,0
2014-01-27 21,55,51,0,4,0,0,0
2014-01-27 22,21,20,0,1,0,0,0
2014-01-27 23,36,29,0,7,0,0,0
2014-01-28 00,24,24,0,0,0,0,0
2014-01-28 01,23,18,0,5,0,0,0
2014-01-28 02,23,19,0,4,0,0,0
2014-01-28 03,24,17,0,7,0,0,0
2014-01-28 04,21,14,0,7,0,0,0
2014-01-28 05,2,2,0,0,0,0,0
2014-01-28 06,18,14,0,4,0,0,0
2014-01-28 07,12,8,0,4,0,0,0
2014-01-28 08,35,30,0,5,0,0,0
2014-01-28 09,32,31,0,1,0,0,0
2014-01-28 10,26,24,0,2,0,0,0
2014-01-28 11,19,18,0,1,0,0,0
2014-01-28 12,11,9,0,2,0,0,0
2014-01-28 13,21,20,0,1,0,0,0
2014-01-28 14,62,58,0,4,0,0,0
2014-01-28 15,57,50,0,7,0,0,0
2014-01-28 16,67,63,0,4,0,0,0
2014-01-28 17,25,24,0,1,0,0,0
2014-01-28 18,28,27,0,1,0,0,0
2014-01-28 19,10,10,0,0,0,0,0
2014-01-28 20,8,8,0,0,0,0,0
2014-01-28 21,7,7,0,0,0,0,0
2014-01-28 22,13,12,0,1,0,0,0
2014-01-28 23,16,14,0,2,0,0,0
2014-01-29 00,12,8,0,4,0,0,0
2014-01-29 01,19,15,0,4,0,0,0
2014-01-29 02,19,15,0,4,0,0,0
2014-01-29 03,13,10,0,3,0,0,0
2014-01-29 04,9,9,0,0,0,0,0
2014-01-29 05,4,4,0,0,0,0,0
2014-01-29 06,21,14,0,7,0,0,0
2014-01-29 07,9,8,0,1,0,0,0
2014-01-29 08,21,18,0,3,0,0,0
2014-01-29 09,31,27,0,4,0,0,0
2014-01-29 10,45,40,0,5,0,0,0
2014-01-29 11,47,42,0,5,0,0,0
2014-01-29 12,26,24,0,2,0,0,0
2014-01-29 13,29,26,0,3,0,0,0
2014-01-29 14,37,37,0,0,0,0,0
2014-01-29 15,29,27,0,2,0,0,0
2014-01-29 16,9,9,0,0,0,0,0
2014-01-29 17,11,9,0,2,0,0,0
2014-01-29 18,5,5,0,0,0,0,0
2014-01-29 19,7,7,0,0,0,0,0
2014-01-29 20,7,7,0,0,0,0,0
2014-01-29 21,27,26,0,1,0,0,0
2014-01-29 22,5,5,0,0,0,0,0
2014-01-29 23,6,5,0,1,0,0,0
2014-01-30 00,10,9,0,1,0,0,0
2014-01-30 01,9,5,0,4,0,0,0
2014-01-30 02,22,18,0,4,0,0,0
2014-01-30 03,6,4,0,2,0,0,0
2014-01-30 04,11,9,0,2,0,0,0
2014-01-30 05,19,14,0,5,0,0,0
2014-01-30 06,3,3,0,0,0,0,0
2014-01-30 07,3,3,0,0,0,0,0
2014-01-30 08,8,4,0,4,0,0,0
2014-01-30 09,25,19,0,6,0,0,0
2014-01-30 10,26,20,0,6,0,0,0
2014-01-30 11,29,23,0,6,0,0,0
2014-01-30 12,24,22,0,2,0,0,0
2014-01-30 13,20,14,0,6,0,0,0
2014-01-30 14,89,87,0,2,0,0,0
2014-01-30 15,46,42,0,4,0,0,0
2014-01-30 16,7,7,0,0,0,0,0
2014-01-30 17,3,3,0,0,0,0,0
2014-01-30 18,4,4,0,0,0,0,0
2014-01-30 19,2,2,0,0,0,0,0
2014-01-30 20,16,16,0,0,0,0,0
2014-01-30 21,10,10,0,0,0,0,0
2014-01-30 22,47,46,0,1,0,0,0
2014-01-30 23,6,6,0,0,0,0,0
2014-01-31 00,38,37,0,1,0,0,0
2014-01-31 01,5,4,0,1,0,0,0
2014-01-31 02,12,10,0,2,0,0,0
2014-01-31 03,8,8,0,0,0,0,0
2014-01-31 04,2,2,0,0,0,0,0
2014-01-31 05,2,1,0,1,0,0,0
2014-01-31 06,2,2,0,0,0,0,0
2014-01-31 07,10,10,0,0,0,0,0
2014-01-31 08,6,6,0,0,0,0,0
2014-01-31 09,24,23,0,1,0,0,0
2014-01-31 10,28,25,0,3,0,0,0
2014-01-31 11,24,23,0,1,0,0,0
2014-01-31 12,26,23,0,3,0,0,0
2014-01-31 13,13,13,0,0,0,0,0
2014-01-31 14,17,17,0,0,0,0,0
2014-01-31 15,4,4,0,0,0,0,0
2014-01-31 16,15,15,0,0,0,0,0
2014-01-31 17,14,13,0,1,0,0,0
2014-01-31 18,17,17,0,0,0,0,0
2014-01-31 19,3,3,0,0,0,0,0
2014-01-31 20,38,38,0,0,0,0,0
2014-01-31 21,19,18,0,1,0,0,0
2014-01-31 22,10,9,0,1,0,0,0
2014-01-31 23,10,10,0,0,0,0,0
2014-02-01 00,54,52,0,2,0,0,0
2014-02-01 01,6,5,0,1,0,0,0
2014-02-01 02,23,23,0,0,0,0,0
2014-02-01 03,9,7,0,2,0,0,0
2014-02-01 04,14,13,0,1,0,0,0
2014-02-01 05,5,5,0,0,0,0,0
2014-02-01 06,7,7,0,0,0,0,0
2014-02-01 07,9,9,0,0,0,0,0
2014-02-01 08,11,11,0,0,0,0,0
2014-02-01 09,12,11,0,1,0,0,0
2014-02-01 10,9,9,0,0,0,0,0
2014-02-01 11,6,6,0,0,0,0,0
2014-02-01 12,10,10,0,0,0,0,0
2014-02-01 13,14,13,0,1,0,0,0
2014-02-01 14,26,26,0,0,0,0,0
2014-02-01 15,32,31,0,1,0,0,0
2014-02-01 16,14,14,0,0,0,0,0
2014-02-01 17,5,5,0,0,0,0,0
2014-02-01 18,11,11,0,0,0,0,0
2014-02-01 19,11,11,0,0,0,0,0
2014-02-01 20,6,5,0,1,0,0,0
2014-02-01 21,2,2,0,0,0,0,0
2014-02-01 22,29,28,0,1,0,0,0
2014-02-01 23,12,12,0,0,0,0,0
2014-02-02 00,30,28,0,2,0,0,0
2014-02-02 01,19,17,0,2,0,0,0
2014-02-02 02,15,13,0,2,0,0,0
2014-02-02 03,3,3,0,0,0,0,0
2014-02-02 04,1,1,0,0,0,0,0
2014-02-02 05,2,1,0,1,0,0,0
2014-02-02 06,2,2,0,0,0,0,0
2014-02-02 07,6,6,0,0,0,0,0
2014-02-02 08,4,4,0,0,0,0,0
2014-02-02 09,32,32,0,0,0,0,0
2014-02-02 10,5,5,0,0,0,0,0
2014-02-02 11,5,5,0,0,0,0,0
2014-02-02 12,13,13,0,0,0,0,0
2014-02-02 13,46,45,0,1,0,0,0
2014-02-02 14,14,14,0,0,0,0,0
2014-02-02 15,4,4,0,0,0,0,0
2014-02-02 16,6,5,0,1,0,0,0
2014-02-02 17,10,10,0,0,0,0,0
2014-02-02 18,12,12,0,0,0,0,0
2014-02-02 19,8,8,0,0,0,0,0
2014-02-02 20,15,15,0,0,0,0,0
2014-02-02 21,8,7,0,1,0,0,0
2014-02-02 22,14,13,0,1,0,0,0
2014-02-02 23,28,28,0,0,0,0,0
2014-02-03 00,14,11,0,3,0,0,0
2014-02-03 01,25,24,0,1,0,0,0
2014-02-03 02,20,18,0,2,0,0,0
2014-02-03 03,3,3,0,0,0,0,0
2014-02-03 04,2,2,0,0,0,0,0
2014-02-03 05,2,2,0,0,0,0,0
2014-02-03 06,5,5,0,0,0,0,0
2014-02-03 07,6,6,0,0,0,0,0
2014-02-03 08,7,7,0,0,0,0,0
2014-02-03 09,10,10,0,0,0,0,0
2014-02-03 10,25,25,0,0,0,0,0
2014-02-03 11,4,4,0,0,0,0,0
2014-02-03 12,4,4,0,0,0,0,0
2014-02-03 13,2,2,0,0,0,0,0
2014-02-03 14,6,6,0,0,0,0,0
2014-02-03 15,6,6,0,0,0,0,0
2014-02-03 16,11,11,0,0,0,0,0
2014-02-03 17,9,9,0,0,0,0,0
2014-02-03 18,5,5,0,0,0,0,0
2014-02-03 19,9,9,0,0,0,0,0
2014-02-03 20,4,4,0,0,0,0,0
2014-02-03 21,9,9,0,0,0,0,0
2014-02-03 22,8,7,0,1,0,0,0
2014-02-03 23,4,4,0,0,0,0,0
2014-02-04 00,24,24,0,0,0,0,0
2014-02-04 01,20,18,0,2,0,0,0
2014-02-04 02,10,8,0,2,0,0,0
2014-02-04 03,13,11,0,2,0,0,0
2014-02-04 04,8,8,0,0,0,0,0
2014-02-04 05,1,1,0,0,0,0,0
2014-02-04 06,4,4,0,0,0,0,0
2014-02-04 07,3,3,0,0,0,0,0
2014-02-04 08,6,6,0,0,0,0,0
2014-02-04 09,11,11,0,0,0,0,0
2014-02-04 10,16,15,0,1,0,0,0
2014-02-04 11,15,14,0,1,0,0,0
2014-02-11 10,4,4,0,0,0,0,0
2014-02-11 11,10,10,0,0,0,0,0
2014-02-11 12,4,4,0,0,0,0,0
2014-02-11 13,2,2,0,0,0,0,0
2014-02-11 14,13,12,0,1,0,0,0
2014-02-11 15,18,18,0,0,0,0,0
2014-02-11 16,6,5,0,1,0,0,0
2014-02-11 17,4,4,0,0,0,0,0
2014-02-11 18,22,20,0,2,0,0,0
2014-02-11 19,23,22,0,1,0,0,0
2014-02-11 20,9,9,0,0,0,0,0
2014-02-11 21,26,23,0,3,0,0,0
2014-02-11 22,8,8,0,0,0,0,0
2014-02-11 23,9,9,0,0,0,0,0
2014-02-12 00,10,7,0,3,0,0,0
2014-02-12 01,6,6,0,0,0,0,0
2014-02-12 02,5,4,0,1,0,0,0
2014-02-12 03,9,7,0,2,0,0,0
2014-02-12 04,8,5,0,3,0,0,0
2014-02-12 05,5,4,0,1,0,0,0
2014-02-12 06,3,3,0,0,0,0,0
2014-02-12 07,2,1,0,1,0,0,0
2014-02-12 08,7,6,0,1,0,0,0
2014-02-12 09,6,6,0,0,0,0,0
2014-02-12 10,9,9,0,0,0,0,0
2014-02-12 11,16,15,0,1,0,0,0
2014-02-12 12,11,9,0,2,0,0,0
2014-02-12 13,8,7,0,1,0,0,0
2014-02-12 14,7,6,0,1,0,0,0
2014-02-12 15,5,5,0,0,0,0,0
2014-02-12 16,5,4,0,1,0,0,0
2014-02-12 17,29,27,0,2,0,0,0
2014-02-12 18,19,17,0,2,0,0,0
2014-02-12 19,13,12,0,1,0,0,0
2014-02-12 20,23,22,0,1,0,0,0
2014-02-12 21,6,5,0,1,0,0,0
2014-02-12 22,4,3,0,1,0,0,0
2014-02-12 23,11,10,0,1,0,0,0
2014-02-13 02,1,1,0,0,0,0,0
2014-02-13 03,5,4,0,1,0,0,0
2014-02-13 06,5,5,0,0,0,0,0
2014-02-13 07,2,2,0,0,0,0,0
2014-02-13 08,9,8,0,1,0,0,0
2014-02-13 09,8,7,0,1,0,0,0
2014-02-13 10,11,9,0,2,0,0,0
2014-02-13 11,8,7,0,1,0,0,0
2014-02-13 12,16,16,0,0,0,0,0
2014-02-13 13,17,17,0,0,0,0,0
2014-02-13 14,17,15,0,2,0,0,0
2014-02-13 15,18,16,0,2,0,0,0
2014-02-13 16,11,11,0,0,0,0,0
2014-02-13 17,17,16,0,1,0,0,0
2014-02-13 18,17,16,0,1,0,0,0
2014-02-13 19,35,33,0,2,0,0,0
2014-02-13 20,12,11,0,1,0,0,0
2014-02-13 21,8,8,0,0,0,0,0
2014-02-13 22,6,5,0,1,0,0,0
2014-02-13 23,10,9,0,1,0,0,0
2014-02-14 00,10,9,0,1,0,0,0
2014-02-14 01,14,12,0,2,0,0,0
2014-02-14 02,1,1,0,0,0,0,0
2014-02-14 03,2,2,0,0,0,0,0
2014-02-14 04,8,7,0,1,0,0,0
2014-02-14 05,10,9,0,1,0,0,0
2014-02-14 07,7,6,0,1,0,0,0
2014-02-14 08,5,4,0,1,0,0,0
2014-02-14 09,4,3,0,1,0,0,0
2014-02-14 10,8,8,0,0,0,0,0
2014-02-14 11,17,16,0,1,0,0,0
2014-02-14 12,8,6,0,2,0,0,0
2014-02-14 13,18,16,0,2,0,0,0
2014-02-14 14,21,18,0,3,0,0,0
2014-02-14 15,34,32,0,2,0,0,0
2014-02-14 16,22,20,0,2,0,0,0
2014-02-14 17,13,10,0,3,0,0,0
2014-02-14 18,28,24,0,4,0,0,0
2014-02-14 19,16,13,0,3,0,0,0
2014-02-14 20,12,11,0,1,0,0,0
2014-02-14 21,10,10,0,0,0,0,0
2014-02-14 22,19,17,0,2,0,0,0
2014-02-14 23,19,19,0,0,0,0,0
2014-02-15 00,3,3,0,0,0,0,0
2014-02-15 01,5,5,0,0,0,0,0
2014-02-15 02,6,5,0,1,0,0,0
2014-02-15 03,7,5,0,2,0,0,0
2014-02-15 04,5,5,0,0,0,0,0
2014-02-15 05,13,13,0,0,0,0,0
2014-02-15 06,4,4,0,0,0,0,0
2014-02-15 07,12,10,0,2,0,0,0
2014-02-15 08,12,11,0,1,0,0,0
2014-02-15 09,7,7,0,0,0,0,0
2014-02-15 10,6,5,0,1,0,0,0
2014-02-15 11,17,15,0,2,0,0,0
2014-02-15 12,18,15,0,3,0,0,0
2014-02-15 13,9,9,0,0,0,0,0
2014-02-15 14,29,24,0,5,0,0,0
2014-02-15 15,32,31,0,1,0,0,0
2014-02-15 16,58,54,0,4,0,0,0
2014-02-15 17,20,17,0,3,0,0,0
2014-02-15 18,13,12,0,1,0,0,0
2014-02-15 19,25,25,0,0,0,0,0
2014-02-15 20,19,18,0,1,0,0,0
2014-02-15 21,19,17,0,2,0,0,0
2014-02-15 22,20,19,0,1,0,0,0
2014-02-15 23,20,19,0,1,0,0,0
2014-02-16 00,17,17,0,0,0,0,0
2014-02-16 01,1,1,0,0,0,0,0
2014-02-16 02,4,4,0,0,0,0,0
2014-02-16 03,1,1,0,0,0,0,0
2014-02-16 05,1,1,0,0,0,0,0
2014-02-16 06,1,1,0,0,0,0,0
2014-02-16 08,3,3,0,0,0,0,0
2014-02-16 09,2,2,0,0,0,0,0
2014-02-16 10,12,12,0,0,0,0,0
2014-02-16 11,11,11,0,0,0,0,0
2014-02-16 12,17,16,0,1,0,0,0
2014-02-16 13,23,21,0,2,0,0,0
2014-02-16 14,29,28,0,1,0,0,0
2014-02-16 15,17,17,0,0,0,0,0
2014-02-16 16,18,16,0,2,0,0,0
2014-02-16 17,25,25,0,0,0,0,0
2014-02-16 18,24,24,0,0,0,0,0
2014-02-16 19,26,26,0,0,0,0,0
2014-02-16 20,45,43,0,2,0,0,0
2014-02-16 21,27,25,0,2,0,0,0
2014-02-16 22,9,8,0,1,0,0,0
2014-02-16 23,19,19,0,0,0,0,0
2014-02-17 00,5,4,0,1,0,0,0
2014-02-17 01,12,12,0,0,0,0,0
2014-02-17 02,10,9,0,1,0,0,0
2014-02-17 03,9,7,0,2,0,0,0
2014-02-17 08,4,4,0,0,0,0,0
2014-02-17 09,16,16,0,0,0,0,0
2014-02-17 10,19,19,0,0,0,0,0
2014-02-17 11,23,22,0,1,0,0,0
2014-02-17 12,18,17,0,1,0,0,0
2014-02-17 13,48,45,0,3,0,0,0
2014-02-17 14,27,25,0,2,0,0,0
2014-02-17 15,55,52,0,3,0,0,0
2014-02-17 16,19,18,0,1,0,0,0
2014-02-17 17,21,20,0,1,0,0,0
2014-02-17 18,16,14,0,2,0,0,0
2014-02-17 19,39,36,0,3,0,0,0
2014-02-17 20,26,23,0,3,0,0,0
2014-02-17 21,13,12,0,1,0,0,0
2014-02-17 22,11,11,0,0,0,0,0
2014-02-17 23,12,12,0,0,0,0,0
2014-02-18 00,8,7,0,1,0,0,0
2014-02-18 01,51,51,0,0,0,0,0
2014-02-18 02,86,86,0,0,0,0,0
2014-02-18 03,15,15,0,0,0,0,0
2014-02-18 04,1,1,0,0,0,0,0
2014-02-18 06,1,1,0,0,0,0,0
2014-02-18 08,11,10,0,1,0,0,0
2014-02-18 09,8,8,0,0,0,0,0
2014-02-18 10,20,20,0,0,0,0,0
2014-02-18 11,37,34,0,3,0,0,0
2014-02-18 12,21,19,0,2,0,0,0
2014-02-18 13,49,46,0,3,0,0,0
2014-02-18 14,39,37,0,2,0,0,0
2014-02-18 15,33,32,0,1,0,0,0
2014-02-18 16,44,41,0,3,0,0,0
2014-02-18 17,33,32,0,1,0,0,0
2014-02-18 18,23,23,0,0,0,0,0
2014-02-18 19,14,14,0,0,0,0,0
2014-02-18 20,39,38,0,1,0,0,0
2014-02-18 21,16,16,0,0,0,0,0
2014-02-18 22,27,26,0,1,0,0,0
2014-02-18 23,9,9,0,0,0,0,0
2014-02-19 00,1,1,0,0,0,0,0
2014-02-19 01,37,37,0,0,0,0,0
2014-02-19 02,28,28,0,0,0,0,0
2014-02-19 04,1,1,0,0,0,0,0
2014-02-19 05,1,0,0,1,0,0,0
2014-02-19 06,1,1,0,0,0,0,0
2014-02-19 07,4,4,0,0,0,0,0
2014-02-19 08,11,11,0,0,0,0,0
2014-02-19 09,10,10,0,0,0,0,0
2014-02-19 10,12,10,0,2,0,0,0
2014-02-19 11,19,18,0,1,0,0,0
2014-02-19 12,9,9,0,0,0,0,0
2014-02-19 13,64,63,0,1,0,0,0
2014-02-19 14,31,30,0,1,0,0,0
2014-02-19 15,34,32,0,2,0,0,0
2014-02-19 16,15,15,0,0,0,0,0
2014-02-19 17,26,24,0,2,0,0,0
2014-02-19 18,26,26,0,0,0,0,0
2014-02-19 19,20,20,0,0,0,0,0
2014-02-19 20,24,23,0,1,0,0,0
2014-02-19 21,9,9,0,0,0,0,0
2014-02-19 22,18,16,0,2,0,0,0
2014-02-19 23,10,10,0,0,0,0,0
2014-02-20 00,24,17,0,7,0,0,0
2014-02-20 01,19,16,0,3,0,0,0
2014-02-20 02,52,52,0,0,0,0,0
2014-02-20 03,14,12,0,2,0,0,0
2014-02-20 04,34,33,0,1,0,0,0
2014-02-20 05,21,19,0,2,0,0,0
2014-02-20 06,17,15,0,2,0,0,0
2014-02-20 07,10,7,0,3,0,0,0
2014-02-20 08,8,8,0,0,0,0,0
2014-02-20 09,21,21,0,0,0,0,0
2014-02-20 10,23,22,0,1,0,0,0
2014-02-20 11,57,54,0,3,0,0,0
2014-02-20 12,48,45,0,3,0,0,0
2014-02-20 13,42,41,0,1,0,0,0
2014-02-20 14,51,51,0,0,0,0,0
2014-02-20 15,60,58,0,2,0,0,0
2014-02-20 16,80,74,0,6,0,0,0
2014-02-20 17,30,28,0,2,0,0,0
2014-02-20 18,6,6,0,0,0,0,0
2014-02-20 19,39,38,0,1,0,0,0
2014-02-20 20,13,13,0,0,0,0,0
2014-02-20 21,21,19,0,2,0,0,0
2014-02-20 22,26,22,0,4,0,0,0
2014-02-20 23,14,14,0,0,0,0,0
2014-02-21 00,10,10,0,0,0,0,0
2014-02-21 01,58,54,0,4,0,0,0
2014-02-21 02,30,28,0,2,0,0,0
2014-02-21 03,3,2,0,1,0,0,0
2014-02-21 04,6,6,0,0,0,0,0
2014-02-21 05,1,0,0,1,0,0,0
2014-02-21 06,17,15,0,2,0,0,0
2014-02-21 07,10,9,0,1,0,0,0
2014-02-21 08,11,10,0,1,0,0,0
2014-02-21 09,24,24,0,0,0,0,0
2014-02-21 10,41,39,0,2,0,0,0
2014-02-21 11,24,22,0,2,0,0,0
2014-02-21 12,42,41,0,1,0,0,0
2014-02-21 13,34,32,0,2,0,0,0
2014-02-21 14,29,26,0,3,0,0,0
2014-02-21 15,24,23,0,1,0,0,0
2014-02-21 16,35,33,0,2,0,0,0
2014-02-21 17,24,24,0,0,0,0,0
2014-02-21 18,23,22,0,1,0,0,0
2014-02-21 19,20,20,0,0,0,0,0
2014-02-21 20,9,9,0,0,0,0,0
2014-02-21 21,28,28,0,0,0,0,0
2014-02-21 22,17,16,0,1,0,0,0
2014-02-21 23,10,10,0,0,0,0,0
2014-02-22 00,9,7,0,2,0,0,0
2014-02-22 01,7,6,0,1,0,0,0
2014-02-22 02,9,8,0,1,0,0,0
2014-02-22 03,6,6,0,0,0,0,0
2014-02-22 04,4,4,0,0,0,0,0
2014-02-22 06,4,3,0,1,0,0,0
2014-02-22 07,12,11,0,1,0,0,0
2014-02-22 08,8,8,0,0,0,0,0
2014-02-22 09,22,19,0,3,0,0,0
2014-02-22 10,20,17,0,3,0,0,0
2014-02-22 11,43,41,0,2,0,0,0
2014-02-22 12,17,16,0,1,0,0,0
2014-02-22 13,19,17,0,2,0,0,0
2014-02-22 14,20,19,0,1,0,0,0
2014-02-22 15,51,49,0,2,0,0,0
2014-02-22 16,67,65,0,2,0,0,0
2014-02-22 17,19,18,0,1,0,0,0
2014-02-22 18,15,14,0,1,0,0,0
2014-02-22 19,23,22,0,1,0,0,0
2014-02-22 20,53,53,0,0,0,0,0
2014-02-22 21,35,34,0,1,0,0,0
2014-02-22 22,31,30,0,1,0,0,0
2014-02-22 23,15,13,0,2,0,0,0
2014-02-23 00,4,4,0,0,0,0,0
2014-02-23 01,13,10,0,3,0,0,0
2014-02-23 02,7,7,0,0,0,0,0
2014-02-23 03,3,2,0,1,0,0,0
2014-02-23 04,11,9,0,2,0,0,0
2014-02-23 05,5,4,0,1,0,0,0
2014-02-23 06,13,8,0,5,0,0,0
2014-02-23 07,9,7,0,2,0,0,0
2014-02-23 08,12,11,0,1,0,0,0
2014-02-23 09,19,18,0,1,0,0,0
2014-02-23 10,21,20,0,1,0,0,0
2014-02-23 11,38,35,0,3,0,0,0
2014-02-23 12,29,27,0,2,0,0,0
2014-02-23 13,20,15,0,5,0,0,0
2014-02-23 14,21,19,0,2,0,0,0
2014-02-23 15,55,55,0,0,0,0,0
2014-02-23 16,51,50,0,1,0,0,0
2014-02-23 17,24,23,0,1,0,0,0
2014-02-23 18,28,26,0,2,0,0,0
2014-02-23 19,32,32,0,0,0,0,0
2014-02-23 20,20,19,0,1,0,0,0
2014-02-23 21,24,24,0,0,0,0,0
2014-02-23 22,29,29,0,0,0,0,0
2014-02-23 23,18,17,0,1,0,0,0
2014-02-24 00,12,11,0,1,0,0,0
2014-02-24 01,9,9,0,0,0,0,0
2014-02-24 02,15,14,0,1,0,0,0
2014-02-24 03,10,9,0,1,0,0,0
2014-02-24 04,9,8,0,1,0,0,0
2014-02-24 05,28,26,0,2,0,0,0
2014-02-24 06,13,11,0,2,0,0,0
2014-02-24 07,11,8,0,3,0,0,0
2014-02-24 08,25,18,0,7,0,0,0
2014-02-24 09,77,74,0,3,0,0,0
2014-02-24 10,54,46,0,8,0,0,0
2014-02-24 11,23,20,0,3,0,0,0
2014-02-24 12,68,65,0,3,0,0,0
2014-02-24 13,36,33,0,3,0,0,0
2014-02-24 14,29,27,0,2,0,0,0
2014-02-24 15,41,39,0,2,0,0,0
2014-02-24 16,38,37,0,1,0,0,0
2014-02-24 17,19,19,0,0,0,0,0
2014-02-24 18,45,41,0,4,0,0,0
2014-02-24 19,33,33,0,0,0,0,0
2014-02-24 20,30,28,0,2,0,0,0
2014-02-24 21,67,65,0,2,0,0,0
2014-02-24 22,31,30,0,1,0,0,0
2014-02-24 23,18,17,0,1,0,0,0
2014-02-25 00,16,13,0,3,0,0,0
2014-02-25 01,43,43,0,0,0,0,0
2014-02-25 02,9,9,0,0,0,0,0
2014-02-25 03,23,21,0,2,0,0,0
2014-02-25 04,2,2,0,0,0,0,0
2014-02-25 05,14,14,0,0,0,0,0
2014-02-25 06,24,22,0,2,0,0,0
2014-02-25 07,14,10,0,4,0,0,0
2014-02-25 08,21,20,0,1,0,0,0
2014-02-25 09,28,27,0,1,0,0,0
2014-02-25 10,28,27,0,1,0,0,0
2014-02-25 11,35,35,0,0,0,0,0
2014-02-25 12,11,7,0,4,0,0,0
2014-02-25 13,16,13,0,3,0,0,0
2014-02-25 14,21,20,0,1,0,0,0
2014-02-25 15,18,17,0,1,0,0,0
2014-02-25 16,20,18,0,2,0,0,0
2014-02-25 17,12,11,0,1,0,0,0
2014-02-25 18,24,23,0,1,0,0,0
2014-02-25 19,23,20,0,3,0,0,0
2014-02-25 20,17,17,0,0,0,0,0
2014-02-25 21,14,13,0,1,0,0,0
2014-02-25 22,15,14,0,1,0,0,0
2014-02-25 23,10,8,0,2,0,0,0
2014-02-26 00,7,7,0,0,0,0,0
2014-02-26 01,4,4,0,0,0,0,0
2014-02-26 02,9,7,0,2,0,0,0
2014-02-26 03,13,12,0,1,0,0,0
2014-02-26 04,3,3,0,0,0,0,0
2014-02-26 05,2,2,0,0,0,0,0
2014-02-26 06,12,9,0,3,0,0,0
2014-02-26 07,15,13,0,2,0,0,0
2014-02-26 08,9,8,0,1,0,0,0
2014-02-26 09,10,10,0,0,0,0,0
2014-02-26 10,49,46,0,3,0,0,0
2014-02-26 11,24,23,0,1,0,0,0
2014-02-26 12,27,25,0,2,0,0,0
2014-02-26 13,19,19,0,0,0,0,0
2014-02-26 14,21,20,0,1,0,0,0
2014-02-26 15,32,28,0,4,0,0,0
2014-02-26 16,36,34,0,2,0,0,0
2014-02-26 17,18,17,0,1,0,0,0
2014-02-26 18,23,22,0,1,0,0,0
2014-02-26 19,17,15,0,2,0,0,0
2014-02-26 20,29,28,0,1,0,0,0
2014-02-26 21,46,43,0,3,0,0,0
2014-02-26 22,21,20,0,1,0,0,0
2014-02-26 23,18,16,0,2,0,0,0
2014-02-27 00,6,5,0,1,0,0,0
2014-02-27 01,14,12,0,2,0,0,0
2014-02-27 02,15,13,0,2,0,0,0
2014-02-27 03,14,10,0,4,0,0,0
2014-02-27 04,44,42,0,2,0,0,0
2014-02-27 05,6,4,0,2,0,0,0
2014-02-27 06,8,6,0,2,0,0,0
2014-02-27 07,12,10,0,2,0,0,0
2014-02-27 08,14,13,0,1,0,0,0
2014-02-27 09,14,12,0,2,0,0,0
2014-02-27 10,8,6,0,2,0,0,0
2014-02-27 11,16,15,0,1,0,0,0
2014-02-27 12,24,22,0,2,0,0,0
2014-02-27 13,12,12,0,0,0,0,0
2014-02-27 14,45,43,0,2,0,0,0
2014-02-27 15,24,23,0,1,0,0,0
2014-02-27 16,11,11,0,0,0,0,0
2014-02-27 17,18,16,0,2,0,0,0
2014-02-27 18,29,26,0,3,0,0,0
2014-02-27 19,45,41,0,4,0,0,0
2014-02-27 20,43,42,0,1,0,0,0
2014-02-27 21,31,28,0,3,0,0,0
2014-02-27 22,37,33,0,4,0,0,0
2014-02-27 23,15,15,0,0,0,0,0
2014-02-28 00,9,8,0,1,0,0,0
2014-02-28 01,21,20,0,1,0,0,0
2014-02-28 02,76,74,0,2,0,0,0
2014-02-28 03,35,33,0,2,0,0,0
2014-02-28 04,26,24,0,2,0,0,0
2014-02-28 05,9,6,0,3,0,0,0
2014-02-28 06,19,18,0,1,0,0,0
2014-02-28 07,17,15,0,2,0,0,0
2014-02-28 08,34,29,0,5,0,0,0
2014-02-28 09,32,30,0,2,0,0,0
2014-02-28 10,25,23,0,2,0,0,0
2014-02-28 11,45,41,0,4,0,0,0
2014-02-28 12,23,22,0,1,0,0,0
2014-02-28 13,45,41,0,4,0,0,0
2014-02-28 14,27,26,0,1,0,0,0
2014-02-28 15,26,24,0,2,0,0,0
2014-02-28 16,20,17,0,3,0,0,0
2014-02-28 17,17,16,0,1,0,0,0
2014-02-28 18,40,39,0,1,0,0,0
2014-02-28 19,48,48,0,0,0,0,0
2014-02-28 20,40,37,0,3,0,0,0
2014-02-28 21,26,26,0,0,0,0,0
2014-02-28 22,34,31,0,3,0,0,0
2014-02-28 23,8,8,0,0,0,0,0
2014-03-01 00,10,10,0,0,0,0,0
2014-03-01 01,3,2,0,1,0,0,0
2014-03-01 02,38,32,0,6,0,0,0
2014-03-01 03,100,97,0,3,0,0,0
2014-03-01 04,27,24,0,3,0,0,0
2014-03-01 05,9,7,0,2,0,0,0
2014-03-01 06,9,9,0,0,0,0,0
2014-03-01 07,3,2,0,1,0,0,0
2014-03-01 08,16,16,0,0,0,0,0
2014-03-01 09,27,25,0,2,0,0,0
2014-03-01 10,58,56,0,2,0,0,0
2014-03-01 11,27,26,0,1,0,0,0
2014-03-01 12,35,31,0,4,0,0,0
2014-03-01 13,35,33,0,2,0,0,0
2014-03-01 14,24,24,0,0,0,0,0
2014-03-01 15,40,36,0,4,0,0,0
2014-03-01 16,24,21,0,3,0,0,0
2014-03-01 17,28,26,0,2,0,0,0
2014-03-01 18,28,27,0,1,0,0,0
2014-03-01 19,14,14,0,0,0,0,0
2014-03-01 20,11,11,0,0,0,0,0
2014-03-01 21,30,30,0,0,0,0,0
2014-03-01 22,34,34,0,0,0,0,0
2014-03-01 23,11,11,0,0,0,0,0
2014-03-02 00,12,11,0,1,0,0,0
2014-03-02 01,19,19,0,0,0,0,0
2014-03-02 02,24,21,0,3,0,0,0
2014-03-02 03,101,99,0,2,0,0,0
2014-03-02 04,48,48,0,0,0,0,0
2014-03-02 05,13,10,0,3,0,0,0
2014-03-02 06,5,4,0,1,0,0,0
2014-03-02 07,10,8,0,2,0,0,0
2014-03-02 08,8,7,0,1,0,0,0
2014-03-02 09,18,16,0,2,0,0,0
2014-03-02 10,17,17,0,0,0,0,0
2014-03-02 11,17,17,0,0,0,0,0
2014-03-02 12,30,27,0,3,0,0,0
2014-03-02 13,31,27,0,4,0,0,0
2014-03-02 14,40,38,0,2,0,0,0
2014-03-02 15,34,29,0,5,0,0,0
2014-03-02 16,15,14,0,1,0,0,0
2014-03-02 17,23,22,0,1,0,0,0
2014-03-02 18,13,11,0,2,0,0,0
2014-03-02 19,21,19,0,2,0,0,0
2014-03-02 20,41,40,0,1,0,0,0
2014-03-02 21,43,39,0,4,0,0,0
2014-03-02 22,48,47,0,1,0,0,0
2014-03-02 23,11,11,0,0,0,0,0
2014-03-03 00,14,13,0,1,0,0,0
2014-03-03 01,14,12,0,2,0,0,0
2014-03-03 02,30,26,0,4,0,0,0
2014-03-03 03,47,47,0,0,0,0,0
2014-03-03 04,22,20,0,2,0,0,0
2014-03-03 05,19,16,0,3,0,0,0
2014-03-03 06,11,10,0,1,0,0,0
2014-03-03 07,8,8,0,0,0,0,0
2014-03-03 08,26,23,0,3,0,0,0
2014-03-03 09,12,10,0,2,0,0,0
2014-03-03 10,28,27,0,1,0,0,0
2014-03-03 11,5,4,0,1,0,0,0
2014-03-03 12,32,31,0,1,0,0,0
2014-03-03 13,27,26,0,1,0,0,0
2014-03-03 14,23,23,0,0,0,0,0
2014-03-03 15,12,11,0,1,0,0,0
2014-03-03 16,20,19,0,1,0,0,0
2014-03-03 17,18,18,0,0,0,0,0
2014-03-03 18,25,24,0,1,0,0,0
2014-03-03 19,19,17,0,2,0,0,0
2014-03-03 20,19,15,0,4,0,0,0
2014-03-03 21,39,35,0,4,0,0,0
2014-03-03 22,31,29,0,2,0,0,0
2014-03-03 23,10,10,0,0,0,0,0
2014-03-04 00,10,10,0,0,0,0,0
2014-03-04 01,9,8,0,1,0,0,0
2014-03-04 02,39,34,0,5,0,0,0
2014-03-04 03,10,9,0,1,0,0,0
2014-03-04 04,17,14,0,3,0,0,0
2014-03-04 05,5,4,0,1,0,0,0
2014-03-04 06,19,17,0,2,0,0,0
2014-03-04 07,6,5,0,1,0,0,0
2014-03-04 08,11,10,0,1,0,0,0
2014-03-04 09,5,5,0,0,0,0,0
2014-03-04 10,31,31,0,0,0,0,0
2014-03-04 11,8,8,0,0,0,0,0
2014-03-04 12,27,23,0,4,0,0,0
2014-03-04 13,17,15,0,2,0,0,0
2014-03-04 14,29,25,0,4,0,0,0
2014-03-04 15,13,12,0,1,0,0,0
2014-03-04 16,7,6,0,1,0,0,0
2014-03-04 17,6,5,0,1,0,0,0
2014-03-04 18,25,24,0,1,0,0,0
2014-03-04 19,11,10,0,1,0,0,0
2014-03-04 20,21,19,0,2,0,0,0
2014-03-04 21,15,15,0,0,0,0,0
2014-03-04 22,11,11,0,0,0,0,0
2014-03-04 23,11,11,0,0,0,0,0
2014-03-05 00,12,12,0,0,0,0,0
2014-03-05 01,36,32,0,4,0,0,0
2014-03-05 02,20,17,0,3,0,0,0
2014-03-05 03,13,13,0,0,0,0,0
2014-03-05 04,2,2,0,0,0,0,0
2014-03-05 05,3,2,0,1,0,0,0
2014-03-05 06,12,12,0,0,0,0,0
2014-03-05 07,5,4,0,1,0,0,0
2014-03-05 08,6,5,0,1,0,0,0
2014-03-05 09,10,8,0,2,0,0,0
2014-03-05 10,8,8,0,0,0,0,0
2014-03-05 11,20,18,0,2,0,0,0
2014-03-05 12,23,21,0,2,0,0,0
2014-03-05 13,16,16,0,0,0,0,0
2014-03-05 14,52,49,0,3,0,0,0
2014-03-05 15,26,24,0,2,0,0,0
2014-03-05 16,18,18,0,0,0,0,0
2014-03-05 17,15,14,0,1,0,0,0
2014-03-05 18,5,5,0,0,0,0,0
2014-03-05 19,13,12,0,1,0,0,0
2014-03-05 20,9,9,0,0,0,0,0
2014-03-05 21,12,11,0,1,0,0,0
2014-03-05 22,14,14,0,0,0,0,0
2014-03-05 23,8,8,0,0,0,0,0
2014-03-06 00,7,6,0,1,0,0,0
2014-03-06 01,7,7,0,0,0,0,0
2014-03-06 02,4,3,0,1,0,0,0
2014-03-06 03,14,11,0,3,0,0,0
2014-03-06 04,14,13,0,1,0,0,0
2014-03-06 05,13,9,0,4,0,0,0
2014-03-06 06,8,8,0,0,0,0,0
2014-03-06 08,1,1,0,0,0,0,0
2014-03-06 09,4,4,0,0,0,0,0
2014-03-06 10,6,6,0,0,0,0,0
2014-03-06 11,8,7,0,1,0,0,0
2014-03-06 12,13,12,0,1,0,0,0
2014-03-06 13,14,14,0,0,0,0,0
2014-03-06 14,6,6,0,0,0,0,0
2014-03-06 15,6,6,0,0,0,0,0
2014-03-06 16,30,29,0,1,0,0,0
2014-03-06 17,27,26,0,1,0,0,0
2014-03-06 18,16,16,0,0,0,0,0
2014-03-06 19,17,15,0,2,0,0,0
2014-03-06 20,8,8,0,0,0,0,0
2014-03-06 21,17,16,0,1,0,0,0
2014-03-06 22,8,8,0,0,0,0,0
2014-03-06 23,11,11,0,0,0,0,0
2014-03-07 00,12,12,0,0,0,0,0
